PlayerCard1,PlayerCard2,DealerHand,Win,Lost,Push,Total
10,10,10,139,249,78,466
10,10,2,220,281,40,541
10,10,3,243,282,29,554
10,10,4,240,262,33,535
10,10,5,251,313,25,589
10,10,6,235,250,26,511
10,10,7,238,249,19,506
10,10,8,254,270,21,545
10,10,9,261,269,38,568
10,10,A,148,384,41,573
10,10,J,174,266,83,523
10,10,K,163,265,74,502
10,10,Q,150,265,104,519
10,2,10,122,433,15,570
10,2,2,139,368,11,518
10,2,3,175,382,10,567
10,2,4,164,399,10,573
10,2,5,201,371,9,581
10,2,6,205,367,8,580
10,2,7,163,395,17,575
10,2,8,141,417,12,570
10,2,9,130,433,11,574
10,2,A,58,555,30,643
10,2,J,120,441,9,570
10,2,K,134,437,16,587
10,2,Q,116,444,10,570
10,3,10,98,417,10,525
10,3,2,164,386,9,559
10,3,3,140,335,8,483
10,3,4,176,378,13,567
10,3,5,195,394,8,597
10,3,6,189,401,10,600
10,3,7,138,426,10,574
10,3,8,115,443,15,573
10,3,9,133,444,16,593
10,3,A,34,517,17,568
10,3,J,115,463,16,594
10,3,K,119,444,9,572
10,3,Q,121,470,12,603
10,4,10,115,390,9,514
10,4,2,179,410,7,596
10,4,3,148,379,9,536
10,4,4,148,375,14,537
10,4,5,192,394,14,600
10,4,6,187,334,7,528
10,4,7,141,427,11,579
10,4,8,138,431,8,577
10,4,9,125,423,8,556
10,4,A,46,520,23,589
10,4,J,101,472,19,592
10,4,K,105,479,10,594
10,4,Q,100,464,15,579
10,5,10,130,469,12,611
10,5,2,133,447,6,586
10,5,3,130,386,7,523
10,5,4,167,381,7,555
10,5,5,164,398,12,574
10,5,6,167,361,7,535
10,5,7,123,451,7,581
10,5,8,107,461,8,576
10,5,9,119,470,13,602
10,5,A,44,544,21,609
10,5,J,106,462,20,588
10,5,K,91,450,11,552
10,5,Q,116,437,10,563
10,6,10,86,446,19,551
10,6,2,158,408,9,575
10,6,3,159,451,14,624
10,6,4,161,430,9,600
10,6,5,160,413,11,584
10,6,6,167,341,2,510
10,6,7,130,432,13,575
10,6,8,123,444,10,577
10,6,9,122,467,5,594
10,6,A,50,512,19,581
10,6,J,110,445,15,570
10,6,K,94,481,11,586
10,6,Q,107,465,9,581
10,7,10,105,406,35,546
10,7,2,122,400,49,571
10,7,3,146,414,62,622
10,7,4,149,387,46,582
10,7,5,169,400,44,613
10,7,6,186,358,55,599
10,7,7,116,325,116,557
10,7,8,113,403,49,565
10,7,9,113,419,46,578
10,7,A,40,499,59,598
10,7,J,93,420,31,544
10,7,K,104,397,49,550
10,7,Q,104,467,44,615
10,8,10,118,378,47,543
10,8,2,175,335,43,553
10,8,3,193,372,48,613
10,8,4,183,343,41,567
10,8,5,159,343,26,528
10,8,6,204,354,34,592
10,8,7,230,345,56,631
10,8,8,142,315,106,563
10,8,9,134,394,36,564
10,8,A,88,451,50,589
10,8,J,137,389,33,559
10,8,K,123,387,45,555
10,8,Q,126,400,42,568
10,9,10,150,364,32,546
10,9,2,201,311,31,543
10,9,3,221,339,46,606
10,9,4,193,362,35,590
10,9,5,251,301,44,596
10,9,6,247,335,34,616
10,9,7,241,303,27,571
10,9,8,250,298,46,594
10,9,9,136,287,91,514
10,9,A,118,415,57,590
10,9,J,151,358,39,548
10,9,K,137,365,41,543
10,9,Q,167,372,34,573
10,A,10,465,0,42,507
10,A,2,504,0,70,574
10,A,3,532,0,74,606
10,A,4,529,0,55,584
10,A,5,509,0,58,567
10,A,6,506,0,47,553
10,A,7,544,0,51,595
10,A,8,521,0,42,563
10,A,9,563,0,31,594
10,A,A,316,0,200,516
10,A,J,522,0,65,587
10,A,K,474,0,61,535
10,A,Q,555,0,59,614
10,J,10,152,286,91,529
10,J,2,270,284,32,586
10,J,3,248,288,39,575
10,J,4,221,310,32,563
10,J,5,235,306,34,575
10,J,6,234,286,25,545
10,J,7,246,295,30,571
10,J,8,240,281,30,551
10,J,9,269,288,40,597
10,J,A,162,370,48,580
10,J,J,176,277,78,531
10,J,K,165,335,102,602
10,J,Q,183,324,111,618
10,K,10,167,261,78,506
10,K,2,254,288,53,595
10,K,3,200,321,30,551
10,K,4,225,287,32,544
10,K,5,236,322,31,589
10,K,6,260,309,32,601
10,K,7,276,315,20,611
10,K,8,250,339,31,620
10,K,9,281,273,49,603
10,K,A,157,388,57,602
10,K,J,186,301,108,595
10,K,K,156,265,82,503
10,K,Q,191,308,94,593
10,Q,10,141,299,94,534
10,Q,2,231,287,37,555
10,Q,3,243,270,44,557
10,Q,4,228,296,34,558
10,Q,5,248,298,32,578
10,Q,6,258,275,29,562
10,Q,7,248,279,35,562
10,Q,8,286,243,18,547
10,Q,9,269,271,35,575
10,Q,A,147,372,49,568
10,Q,J,186,303,101,590
10,Q,K,182,326,96,604
10,Q,Q,160,291,95,546
2,10,10,115,396,12,523
2,10,2,161,379,8,548
2,10,3,175,399,12,586
2,10,4,190,360,10,560
2,10,5,202,365,9,576
2,10,6,188,377,9,574
2,10,7,149,443,19,611
2,10,8,127,427,8,562
2,10,9,123,462,5,590
2,10,A,67,520,13,600
2,10,J,123,425,22,570
2,10,K,132,441,14,587
2,10,Q,115,453,12,580
2,2,10,109,420,5,534
2,2,2,147,331,7,485
2,2,3,188,350,5,543
2,2,4,203,344,3,550
2,2,5,213,333,2,548
2,2,6,231,329,5,565
2,2,7,141,387,10,538
2,2,8,130,393,8,531
2,2,9,132,390,1,523
2,2,A,43,468,13,524
2,2,J,111,410,5,526
2,2,K,88,465,10,563
2,2,Q,106,424,7,537
2,3,10,101,454,6,561
2,3,2,179,344,10,533
2,3,3,188,368,11,567
2,3,4,194,368,7,569
2,3,5,231,351,4,586
2,3,6,238,330,4,572
2,3,7,162,414,6,582
2,3,8,146,459,15,620
2,3,9,132,425,8,565
2,3,A,39,523,8,570
2,3,J,124,456,9,589
2,3,K,119,438,5,562
2,3,Q,150,396,5,551
2,4,10,126,480,12,618
2,4,2,168,365,7,540
2,4,3,172,343,6,521
2,4,4,183,330,8,521
2,4,5,252,374,9,635
2,4,6,207,342,5,554
2,4,7,121,417,19,557
2,4,8,136,460,9,605
2,4,9,107,435,7,549
2,4,A,29,547,8,584
2,4,J,127,446,9,582
2,4,K,92,444,12,548
2,4,Q,135,466,9,610
2,5,10,124,451,8,583
2,5,2,159,369,11,539
2,5,3,216,368,11,595
2,5,4,199,345,13,557
2,5,5,206,324,8,538
2,5,6,201,347,11,559
2,5,7,157,376,22,555
2,5,8,140,434,21,595
2,5,9,130,433,17,580
2,5,A,52,513,16,581
2,5,J,124,416,13,553
2,5,K,129,386,9,524
2,5,Q,120,417,15,552
2,6,10,136,455,21,612
2,6,2,179,344,19,542
2,6,3,180,344,12,536
2,6,4,182,369,9,560
2,6,5,205,336,18,559
2,6,6,211,296,12,519
2,6,7,172,420,21,613
2,6,8,168,391,22,581
2,6,9,147,420,20,587
2,6,A,47,526,8,581
2,6,J,127,459,14,600
2,6,K,101,431,16,548
2,6,Q,107,450,13,570
2,7,10,126,436,16,578
2,7,2,198,369,13,580
2,7,3,194,350,10,554
2,7,4,197,349,13,559
2,7,5,210,392,14,616
2,7,6,221,292,12,525
2,7,7,152,358,15,525
2,7,8,169,397,18,584
2,7,9,159,398,34,591
2,7,A,77,529,19,625
2,7,J,130,446,11,587
2,7,K,146,443,19,608
2,7,Q,135,434,10,579
2,8,10,139,384,22,545
2,8,2,169,319,9,497
2,8,3,190,327,15,532
2,8,4,191,329,6,526
2,8,5,219,367,12,598
2,8,6,236,315,17,568
2,8,7,207,404,18,629
2,8,8,139,369,23,531
2,8,9,153,367,17,537
2,8,A,72,504,17,593
2,8,J,144,384,25,553
2,8,K,143,402,24,569
2,8,Q,144,438,28,610
2,9,10,178,389,15,582
2,9,2,217,311,20,548
2,9,3,242,333,24,599
2,9,4,249,292,20,561
2,9,5,291,315,11,617
2,9,6,291,297,11,599
2,9,7,214,345,17,576
2,9,8,206,354,25,585
2,9,9,173,289,9,471
2,9,A,89,426,44,559
2,9,J,180,351,24,555
2,9,K,187,362,16,565
2,9,Q,189,392,19,600
2,A,10,164,369,19,552
2,A,2,201,333,15,549
2,A,3,232,305,12,549
2,A,4,269,296,14,579
2,A,5,235,318,18,571
2,A,6,236,286,7,529
2,A,7,222,389,23,634
2,A,8,199,379,20,598
2,A,9,191,381,21,593
2,A,A,87,466,22,575
2,A,J,177,409,20,606
2,A,K,168,396,20,584
2,A,Q,155,419,17,591
2,J,10,142,466,14,622
2,J,2,140,378,9,527
2,J,3,164,354,9,527
2,J,4,175,380,9,564
2,J,5,185,371,5,561
2,J,6,196,336,5,537
2,J,7,155,452,8,615
2,J,8,151,413,7,571
2,J,9,135,422,11,568
2,J,A,56,483,19,558
2,J,J,100,442,5,547
2,J,K,112,442,17,571
2,J,Q,95,480,15,590
2,K,10,111,416,11,538
2,K,2,159,376,12,547
2,K,3,182,384,16,582
2,K,4,190,353,8,551
2,K,5,181,373,10,564
2,K,6,202,358,12,572
2,K,7,141,423,12,576
2,K,8,135,424,8,567
2,K,9,101,416,11,528
2,K,A,44,501,21,566
2,K,J,128,423,18,569
2,K,K,99,437,8,544
2,K,Q,131,443,10,584
2,Q,10,124,446,13,583
2,Q,2,171,378,7,556
2,Q,3,164,402,10,576
2,Q,4,183,388,9,580
2,Q,5,191,371,11,573
2,Q,6,181,331,10,522
2,Q,7,142,391,4,537
2,Q,8,141,427,16,584
2,Q,9,138,454,18,610
2,Q,A,55,514,17,586
2,Q,J,106,462,12,580
2,Q,K,123,428,9,560
2,Q,Q,117,430,14,561
3,10,10,95,427,8,530
3,10,2,164,384,11,559
3,10,3,162,376,7,545
3,10,4,190,427,8,625
3,10,5,160,390,11,561
3,10,6,196,360,9,565
3,10,7,137,434,9,580
3,10,8,118,452,10,580
3,10,9,128,440,17,585
3,10,A,44,501,19,564
3,10,J,120,423,12,555
3,10,K,106,444,13,563
3,10,Q,123,448,7,578
3,2,10,142,402,6,550
3,2,2,177,343,9,529
3,2,3,178,346,6,530
3,2,4,173,362,4,539
3,2,5,209,365,4,578
3,2,6,209,317,8,534
3,2,7,134,427,8,569
3,2,8,148,423,5,576
3,2,9,138,439,7,584
3,2,A,44,503,6,553
3,2,J,121,436,10,567
3,2,K,123,475,7,605
3,2,Q,120,472,13,605
3,3,10,95,423,8,526
3,3,2,184,380,8,572
3,3,3,156,303,8,467
3,3,4,164,323,4,491
3,3,5,190,363,10,563
3,3,6,226,308,7,541
3,3,7,145,369,11,525
3,3,8,122,382,7,511
3,3,9,140,420,10,570
3,3,A,35,493,15,543
3,3,J,124,393,6,523
3,3,K,123,402,9,534
3,3,Q,122,418,7,547
3,4,10,115,430,21,566
3,4,2,182,396,16,594
3,4,3,189,372,14,575
3,4,4,181,356,15,552
3,4,5,215,354,15,584
3,4,6,214,329,14,557
3,4,7,162,378,24,564
3,4,8,119,424,12,555
3,4,9,120,404,8,532
3,4,A,49,504,17,570
3,4,J,139,477,15,631
3,4,K,112,432,13,557
3,4,Q,109,490,15,614
3,5,10,126,462,13,601
3,5,2,193,388,20,601
3,5,3,167,358,13,538
3,5,4,226,353,16,595
3,5,5,225,334,16,575
3,5,6,230,316,16,562
3,5,7,191,396,18,605
3,5,8,129,401,16,546
3,5,9,146,433,15,594
3,5,A,41,551,13,605
3,5,J,115,430,13,558
3,5,K,136,412,16,564
3,5,Q,127,425,8,560
3,6,10,96,445,11,552
3,6,2,212,416,16,644
3,6,3,188,342,17,547
3,6,4,216,344,15,575
3,6,5,232,347,10,589
3,6,6,224,292,14,530
3,6,7,184,385,24,593
3,6,8,154,384,22,560
3,6,9,144,415,23,582
3,6,A,59,486,17,562
3,6,J,144,433,15,592
3,6,K,135,438,15,588
3,6,Q,112,445,19,576
3,7,10,154,405,20,579
3,7,2,190,376,18,584
3,7,3,191,343,16,550
3,7,4,225,374,25,624
3,7,5,206,328,21,555
3,7,6,236,316,13,565
3,7,7,184,346,14,544
3,7,8,187,405,11,603
3,7,9,152,402,13,567
3,7,A,44,528,24,596
3,7,J,175,437,20,632
3,7,K,152,409,26,587
3,7,Q,136,417,23,576
3,8,10,175,400,18,593
3,8,2,247,323,18,588
3,8,3,194,314,19,527
3,8,4,244,292,13,549
3,8,5,252,287,19,558
3,8,6,272,273,11,556
3,8,7,226,343,24,593
3,8,8,203,357,15,575
3,8,9,189,345,15,549
3,8,A,89,462,42,593
3,8,J,201,384,26,611
3,8,K,168,352,29,549
3,8,Q,205,399,23,627
3,9,10,130,430,20,580
3,9,2,159,422,7,588
3,9,3,176,385,11,572
3,9,4,159,390,9,558
3,9,5,221,372,12,605
3,9,6,196,351,13,560
3,9,7,136,411,7,554
3,9,8,138,408,10,556
3,9,9,136,419,10,565
3,9,A,53,477,21,551
3,9,J,123,446,10,579
3,9,K,118,479,19,616
3,9,Q,112,391,10,513
3,A,10,164,379,18,561
3,A,2,217,350,11,578
3,A,3,194,306,13,513
3,A,4,259,315,16,590
3,A,5,250,304,17,571
3,A,6,306,284,14,604
3,A,7,195,345,19,559
3,A,8,169,386,21,576
3,A,9,207,379,21,607
3,A,A,72,443,26,541
3,A,J,189,377,18,584
3,A,K,157,377,18,552
3,A,Q,180,408,16,604
3,J,10,105,459,14,578
3,J,2,178,380,16,574
3,J,3,163,362,10,535
3,J,4,198,387,10,595
3,J,5,171,383,10,564
3,J,6,189,384,7,580
3,J,7,142,436,17,595
3,J,8,134,418,12,564
3,J,9,135,468,15,618
3,J,A,55,522,27,604
3,J,J,111,403,11,525
3,J,K,97,418,10,525
3,J,Q,116,471,6,593
3,K,10,118,423,14,555
3,K,2,140,411,8,559
3,K,3,163,355,6,524
3,K,4,159,399,5,563
3,K,5,186,380,16,582
3,K,6,196,335,7,538
3,K,7,154,429,13,596
3,K,8,148,460,14,622
3,K,9,128,451,7,586
3,K,A,58,483,21,562
3,K,J,105,447,13,565
3,K,K,92,438,13,543
3,K,Q,132,424,11,567
3,Q,10,103,458,15,576
3,Q,2,153,409,1,563
3,Q,3,173,332,8,513
3,Q,4,179,406,13,598
3,Q,5,188,355,7,550
3,Q,6,220,362,14,596
3,Q,7,155,409,12,576
3,Q,8,121,473,12,606
3,Q,9,129,443,18,590
3,Q,A,37,516,19,572
3,Q,J,104,436,14,554
3,Q,K,110,431,14,555
3,Q,Q,89,406,10,505
4,10,10,109,402,8,519
4,10,2,171,414,14,599
4,10,3,165,428,9,602
4,10,4,159,355,9,523
4,10,5,186,368,14,568
4,10,6,187,384,15,586
4,10,7,129,421,15,565
4,10,8,151,435,10,596
4,10,9,130,441,5,576
4,10,A,44,527,16,587
4,10,J,102,461,14,577
4,10,K,104,478,10,592
4,10,Q,109,481,10,600
4,2,10,107,441,10,558
4,2,2,175,355,10,540
4,2,3,176,369,6,551
4,2,4,184,334,10,528
4,2,5,200,355,7,562
4,2,6,218,345,13,576
4,2,7,155,411,15,581
4,2,8,150,424,10,584
4,2,9,124,422,12,558
4,2,A,45,525,6,576
4,2,J,105,455,5,565
4,2,K,105,444,8,557
4,2,Q,110,456,11,577
4,3,10,118,456,15,589
4,3,2,147,369,8,524
4,3,3,196,319,12,527
4,3,4,173,344,10,527
4,3,5,214,361,10,585
4,3,6,213,346,14,573
4,3,7,144,408,20,572
4,3,8,127,375,11,513
4,3,9,125,421,12,558
4,3,A,49,480,22,551
4,3,J,138,463,18,619
4,3,K,130,409,9,548
4,3,Q,116,482,15,613
4,4,10,119,404,10,533
4,4,2,182,365,21,568
4,4,3,164,336,9,509
4,4,4,171,313,11,495
4,4,5,181,302,14,497
4,4,6,224,325,8,557
4,4,7,162,369,15,546
4,4,8,135,388,30,553
4,4,9,131,428,11,570
4,4,A,41,448,12,501
4,4,J,112,388,14,514
4,4,K,88,392,19,499
4,4,Q,113,404,21,538
4,5,10,122,432,25,579
4,5,2,184,397,13,594
4,5,3,184,397,11,592
4,5,4,193,323,22,538
4,5,5,208,337,8,553
4,5,6,223,344,11,578
4,5,7,198,383,16,597
4,5,8,139,378,16,533
4,5,9,138,399,24,561
4,5,A,40,513,23,576
4,5,J,127,433,24,584
4,5,K,110,442,25,577
4,5,Q,134,427,15,576
4,6,10,128,427,24,579
4,6,2,198,385,19,602
4,6,3,221,346,14,581
4,6,4,211,347,12,570
4,6,5,245,322,13,580
4,6,6,203,288,11,502
4,6,7,186,421,21,628
4,6,8,152,360,17,529
4,6,9,184,435,10,629
4,6,A,77,490,29,596
4,6,J,154,412,31,597
4,6,K,115,392,23,530
4,6,Q,140,420,19,579
4,7,10,175,382,20,577
4,7,2,230,310,24,564
4,7,3,247,327,15,589
4,7,4,246,274,21,541
4,7,5,282,320,19,621
4,7,6,237,296,13,546
4,7,7,223,345,15,583
4,7,8,218,360,16,594
4,7,9,166,334,15,515
4,7,A,103,450,41,594
4,7,J,164,374,18,556
4,7,K,195,372,12,579
4,7,Q,184,344,30,558
4,8,10,109,402,11,522
4,8,2,173,404,8,585
4,8,3,168,389,7,564
4,8,4,158,350,8,516
4,8,5,184,354,5,543
4,8,6,207,322,7,536
4,8,7,157,413,18,588
4,8,8,115,410,11,536
4,8,9,125,436,13,574
4,8,A,57,499,27,583
4,8,J,108,422,10,540
4,8,K,102,442,14,558
4,8,Q,128,434,11,573
4,9,10,117,441,12,570
4,9,2,161,367,10,538
4,9,3,174,411,10,595
4,9,4,160,341,4,505
4,9,5,207,405,9,621
4,9,6,182,359,9,550
4,9,7,144,409,10,563
4,9,8,149,426,11,586
4,9,9,114,408,17,539
4,9,A,56,533,29,618
4,9,J,116,479,22,617
4,9,K,122,424,21,567
4,9,Q,135,427,8,570
4,A,10,147,403,20,570
4,A,2,231,320,19,570
4,A,3,226,333,16,575
4,A,4,224,310,18,552
4,A,5,235,304,20,559
4,A,6,270,274,16,560
4,A,7,198,327,9,534
4,A,8,168,392,28,588
4,A,9,186,399,15,600
4,A,A,73,451,22,546
4,A,J,154,395,20,569
4,A,K,149,413,18,580
4,A,Q,183,419,25,627
4,J,10,126,413,24,563
4,J,2,157,413,15,585
4,J,3,171,388,9,568
4,J,4,135,370,11,516
4,J,5,190,390,14,594
4,J,6,167,368,9,544
4,J,7,119,425,7,551
4,J,8,135,458,13,606
4,J,9,118,417,10,545
4,J,A,45,525,24,594
4,J,J,93,419,11,523
4,J,K,115,489,4,608
4,J,Q,107,443,8,558
4,K,10,99,424,14,537
4,K,2,134,418,11,563
4,K,3,165,440,9,614
4,K,4,150,372,7,529
4,K,5,171,409,10,590
4,K,6,193,368,8,569
4,K,7,131,415,8,554
4,K,8,134,383,11,528
4,K,9,112,424,8,544
4,K,A,39,513,25,577
4,K,J,103,444,17,564
4,K,K,112,422,10,544
4,K,Q,104,420,9,533
4,Q,10,94,463,14,571
4,Q,2,143,436,14,593
4,Q,3,168,393,14,575
4,Q,4,144,370,10,524
4,Q,5,160,366,5,531
4,Q,6,202,351,6,559
4,Q,7,127,445,15,587
4,Q,8,114,444,12,570
4,Q,9,132,507,11,650
4,Q,A,35,510,11,556
4,Q,J,103,438,20,561
4,Q,K,137,425,12,574
4,Q,Q,104,398,7,509
5,10,10,86,421,6,513
5,10,2,151,408,8,567
5,10,3,155,456,8,619
5,10,4,161,399,9,569
5,10,5,164,356,10,530
5,10,6,184,391,11,586
5,10,7,143,394,15,552
5,10,8,107,424,13,544
5,10,9,112,434,9,555
5,10,A,43,500,18,561
5,10,J,101,494,10,605
5,10,K,95,427,12,534
5,10,Q,96,471,13,580
5,2,10,116,462,7,585
5,2,2,154,351,16,521
5,2,3,197,370,11,578
5,2,4,204,360,11,575
5,2,5,236,321,6,563
5,2,6,213,331,15,559
5,2,7,158,438,24,620
5,2,8,135,421,18,574
5,2,9,134,460,12,606
5,2,A,49,508,15,572
5,2,J,120,449,13,582
5,2,K,102,426,9,537
5,2,Q,133,437,8,578
5,3,10,113,433,13,559
5,3,2,204,399,19,622
5,3,3,198,311,17,526
5,3,4,235,373,13,621
5,3,5,194,306,12,512
5,3,6,238,315,5,558
5,3,7,188,406,10,604
5,3,8,133,426,21,580
5,3,9,123,415,7,545
5,3,A,56,508,22,586
5,3,J,133,453,11,597
5,3,K,116,466,18,600
5,3,Q,112,452,17,581
5,4,10,140,464,6,610
5,4,2,201,417,16,634
5,4,3,190,344,20,554
5,4,4,172,306,22,500
5,4,5,192,326,11,529
5,4,6,221,323,12,556
5,4,7,161,386,13,560
5,4,8,180,411,17,608
5,4,9,140,410,22,572
5,4,A,61,526,30,617
5,4,J,133,405,10,548
5,4,K,151,444,9,604
5,4,Q,119,472,18,609
5,5,10,126,372,26,524
5,5,2,179,346,10,535
5,5,3,184,329,25,538
5,5,4,199,333,17,549
5,5,5,178,304,20,502
5,5,6,245,279,12,536
5,5,7,172,351,18,541
5,5,8,158,362,15,535
5,5,9,155,341,18,514
5,5,A,58,439,23,520
5,5,J,138,355,13,506
5,5,K,140,365,33,538
5,5,Q,143,373,18,534
5,6,10,208,374,25,607
5,6,2,206,342,14,562
5,6,3,245,288,15,548
5,6,4,281,319,24,624
5,6,5,250,270,14,534
5,6,6,253,220,13,486
5,6,7,241,383,19,643
5,6,8,212,342,17,571
5,6,9,211,365,11,587
5,6,A,93,411,54,558
5,6,J,184,365,20,569
5,6,K,186,389,21,596
5,6,Q,190,417,21,628
5,7,10,120,456,12,588
5,7,2,155,402,9,566
5,7,3,174,393,11,578
5,7,4,180,413,4,597
5,7,5,181,351,12,544
5,7,6,185,330,9,524
5,7,7,135,392,11,538
5,7,8,129,426,7,562
5,7,9,127,448,10,585
5,7,A,53,508,17,578
5,7,J,106,402,12,520
5,7,K,132,451,15,598
5,7,Q,116,434,15,565
5,8,10,118,459,16,593
5,8,2,140,403,19,562
5,8,3,168,387,16,571
5,8,4,175,392,12,579
5,8,5,170,352,5,527
5,8,6,173,375,11,559
5,8,7,128,375,9,512
5,8,8,122,438,15,575
5,8,9,129,422,9,560
5,8,A,50,541,21,612
5,8,J,120,470,8,598
5,8,K,115,436,13,564
5,8,Q,121,443,12,576
5,9,10,102,431,11,544
5,9,2,139,429,10,578
5,9,3,145,396,4,545
5,9,4,190,394,13,597
5,9,5,179,346,5,530
5,9,6,194,359,3,556
5,9,7,136,428,10,574
5,9,8,133,447,9,589
5,9,9,122,458,8,588
5,9,A,50,490,19,559
5,9,J,108,430,9,547
5,9,K,113,466,13,592
5,9,Q,122,480,6,608
5,A,10,142,402,14,558
5,A,2,210,351,16,577
5,A,3,224,340,16,580
5,A,4,245,326,12,583
5,A,5,263,299,13,575
5,A,6,263,248,17,528
5,A,7,196,363,18,577
5,A,8,193,372,20,585
5,A,9,157,396,16,569
5,A,A,85,414,21,520
5,A,J,144,417,16,577
5,A,K,158,417,19,594
5,A,Q,172,392,15,579
5,J,10,124,480,12,616
5,J,2,133,432,10,575
5,J,3,157,400,12,569
5,J,4,180,423,10,613
5,J,5,161,382,6,549
5,J,6,183,391,9,583
5,J,7,143,426,9,578
5,J,8,108,429,15,552
5,J,9,113,448,9,570
5,J,A,37,515,14,566
5,J,J,91,454,8,553
5,J,K,107,475,10,592
5,J,Q,94,441,17,552
5,K,10,114,459,9,582
5,K,2,154,420,10,584
5,K,3,131,419,12,562
5,K,4,159,424,11,594
5,K,5,174,390,10,574
5,K,6,188,398,8,594
5,K,7,145,414,8,567
5,K,8,134,445,7,586
5,K,9,100,516,9,625
5,K,A,63,554,17,634
5,K,J,121,433,25,579
5,K,K,92,446,11,549
5,K,Q,94,476,9,579
5,Q,10,118,462,17,597
5,Q,2,146,423,11,580
5,Q,3,165,407,6,578
5,Q,4,186,407,2,595
5,Q,5,162,366,10,538
5,Q,6,169,388,8,565
5,Q,7,134,418,16,568
5,Q,8,119,449,8,576
5,Q,9,117,462,13,592
5,Q,A,47,546,16,609
5,Q,J,105,487,10,602
5,Q,K,89,425,15,529
5,Q,Q,95,413,14,522
6,10,10,79,474,14,567
6,10,2,113,437,14,564
6,10,3,152,410,3,565
6,10,4,170,418,7,595
6,10,5,151,419,13,583
6,10,6,166,371,9,546
6,10,7,121,433,8,562
6,10,8,111,466,6,583
6,10,9,117,454,16,587
6,10,A,51,496,11,558
6,10,J,97,452,14,563
6,10,K,116,456,11,583
6,10,Q,82,492,8,582
6,2,10,124,408,17,549
6,2,2,179,345,16,540
6,2,3,187,384,15,586
6,2,4,196,384,9,589
6,2,5,203,373,17,593
6,2,6,215,316,11,542
6,2,7,163,391,20,574
6,2,8,139,372,25,536
6,2,9,114,413,14,541
6,2,A,54,496,19,569
6,2,J,94,448,16,558
6,2,K,141,418,13,572
6,2,Q,133,457,9,599
6,3,10,134,414,9,557
6,3,2,216,336,12,564
6,3,3,159,362,18,539
6,3,4,237,359,12,608
6,3,5,201,314,17,532
6,3,6,210,319,8,537
6,3,7,168,390,13,571
6,3,8,154,403,18,575
6,3,9,148,413,25,586
6,3,A,41,530,20,591
6,3,J,129,410,27,566
6,3,K,136,435,14,585
6,3,Q,128,446,21,595
6,4,10,142,407,24,573
6,4,2,182,349,11,542
6,4,3,221,362,13,596
6,4,4,188,342,19,549
6,4,5,236,336,12,584
6,4,6,240,286,11,537
6,4,7,196,404,21,621
6,4,8,162,388,20,570
6,4,9,193,368,11,572
6,4,A,67,448,29,544
6,4,J,135,360,24,519
6,4,K,136,384,25,545
6,4,Q,143,455,27,625
6,5,10,186,388,21,595
6,5,2,245,297,24,566
6,5,3,252,318,17,587
6,5,4,250,292,32,574
6,5,5,232,286,17,535
6,5,6,233,257,21,511
6,5,7,234,336,15,585
6,5,8,210,392,19,621
6,5,9,200,365,25,590
6,5,A,104,454,49,607
6,5,J,197,352,23,572
6,5,K,185,350,16,551
6,5,Q,177,371,28,576
6,6,10,113,383,10,506
6,6,2,167,382,14,563
6,6,3,149,374,5,528
6,6,4,196,344,9,549
6,6,5,204,366,3,573
6,6,6,161,295,4,460
6,6,7,142,402,9,553
6,6,8,121,404,6,531
6,6,9,104,419,14,537
6,6,A,47,466,17,530
6,6,J,108,420,6,534
6,6,K,104,458,8,570
6,6,Q,134,423,23,580
6,7,10,106,433,11,550
6,7,2,156,423,13,592
6,7,3,172,394,10,576
6,7,4,183,408,13,604
6,7,5,189,391,13,593
6,7,6,185,338,0,523
6,7,7,144,402,10,556
6,7,8,127,434,13,574
6,7,9,114,421,11,546
6,7,A,46,505,28,579
6,7,J,117,451,11,579
6,7,K,116,429,14,559
6,7,Q,117,444,16,577
6,8,10,96,426,11,533
6,8,2,155,407,13,575
6,8,3,199,433,11,643
6,8,4,175,369,7,551
6,8,5,178,408,7,593
6,8,6,190,326,9,525
6,8,7,136,430,10,576
6,8,8,115,397,6,518
6,8,9,114,444,13,571
6,8,A,44,512,32,588
6,8,J,88,465,8,561
6,8,K,114,429,19,562
6,8,Q,110,449,24,583
6,9,10,106,414,16,536
6,9,2,158,430,17,605
6,9,3,167,398,19,584
6,9,4,152,395,16,563
6,9,5,170,428,12,610
6,9,6,143,341,6,490
6,9,7,128,459,6,593
6,9,8,116,440,16,572
6,9,9,98,464,10,572
6,9,A,40,547,22,609
6,9,J,115,466,8,589
6,9,K,98,423,9,530
6,9,Q,102,478,11,591
6,A,10,162,370,56,588
6,A,2,218,289,63,570
6,A,3,251,296,64,611
6,A,4,269,275,66,610
6,A,5,264,276,66,606
6,A,6,286,195,56,537
6,A,7,226,213,150,589
6,A,8,165,358,59,582
6,A,9,186,365,63,614
6,A,A,57,414,68,539
6,A,J,147,370,66,583
6,A,K,140,372,58,570
6,A,Q,160,378,49,587
6,J,10,96,485,7,588
6,J,2,165,423,13,601
6,J,3,166,445,9,620
6,J,4,165,380,7,552
6,J,5,173,408,8,589
6,J,6,152,418,12,582
6,J,7,117,433,5,555
6,J,8,139,427,8,574
6,J,9,119,461,7,587
6,J,A,45,508,20,573
6,J,J,107,430,15,552
6,J,K,99,455,10,564
6,J,Q,118,455,11,584
6,K,10,95,429,9,533
6,K,2,164,427,11,602
6,K,3,124,413,8,545
6,K,4,158,399,9,566
6,K,5,159,433,6,598
6,K,6,159,400,10,569
6,K,7,140,433,9,582
6,K,8,100,449,7,556
6,K,9,112,444,5,561
6,K,A,40,473,20,533
6,K,J,120,470,12,602
6,K,K,102,437,11,550
6,K,Q,93,449,5,547
6,Q,10,109,478,8,595
6,Q,2,135,436,5,576
6,Q,3,127,417,12,556
6,Q,4,163,405,10,578
6,Q,5,169,430,5,604
6,Q,6,154,356,1,511
6,Q,7,145,471,9,625
6,Q,8,117,462,12,591
6,Q,9,93,470,15,578
6,Q,A,53,527,15,595
6,Q,J,107,479,14,600
6,Q,K,105,484,11,600
6,Q,Q,100,436,13,549
7,10,10,79,388,37,504
7,10,2,175,385,52,612
7,10,3,139,380,46,565
7,10,4,153,395,51,599
7,10,5,168,367,44,579
7,10,6,180,359,53,592
7,10,7,127,307,106,540
7,10,8,130,416,45,591
7,10,9,125,381,32,538
7,10,A,39,437,50,526
7,10,J,110,443,55,608
7,10,K,104,425,40,569
7,10,Q,101,436,38,575
7,2,10,138,451,15,604
7,2,2,179,355,9,543
7,2,3,204,340,25,569
7,2,4,209,392,13,614
7,2,5,219,319,19,557
7,2,6,232,344,18,594
7,2,7,161,358,9,528
7,2,8,187,373,17,577
7,2,9,138,458,19,615
7,2,A,84,492,15,591
7,2,J,133,455,18,606
7,2,K,119,422,22,563
7,2,Q,128,429,17,574
7,3,10,152,420,30,602
7,3,2,223,357,12,592
7,3,3,166,361,11,538
7,3,4,223,339,17,579
7,3,5,221,351,13,585
7,3,6,242,327,13,582
7,3,7,155,371,10,536
7,3,8,194,369,19,582
7,3,9,177,349,15,541
7,3,A,68,484,23,575
7,3,J,141,406,17,564
7,3,K,128,418,22,568
7,3,Q,147,419,29,595
7,4,10,178,342,22,542
7,4,2,218,315,21,554
7,4,3,236,317,14,567
7,4,4,242,280,16,538
7,4,5,255,290,12,557
7,4,6,290,295,18,603
7,4,7,179,339,24,542
7,4,8,205,393,12,610
7,4,9,192,356,24,572
7,4,A,98,427,42,567
7,4,J,180,364,20,564
7,4,K,196,377,20,593
7,4,Q,174,407,30,611
7,5,10,99,437,15,551
7,5,2,164,461,7,632
7,5,3,170,381,11,562
7,5,4,194,412,7,613
7,5,5,185,377,7,569
7,5,6,214,372,12,598
7,5,7,164,414,7,585
7,5,8,119,422,9,550
7,5,9,133,417,13,563
7,5,A,58,486,15,559
7,5,J,122,448,13,583
7,5,K,99,438,9,546
7,5,Q,124,424,12,560
7,6,10,110,453,15,578
7,6,2,181,385,5,571
7,6,3,173,405,13,591
7,6,4,204,371,12,587
7,6,5,194,415,14,623
7,6,6,171,365,5,541
7,6,7,137,462,12,611
7,6,8,124,492,11,627
7,6,9,114,390,14,518
7,6,A,52,520,23,595
7,6,J,112,464,15,591
7,6,K,117,447,13,577
7,6,Q,126,440,14,580
7,7,10,108,429,13,550
7,7,2,151,356,5,512
7,7,3,132,389,10,531
7,7,4,174,399,10,583
7,7,5,179,390,12,581
7,7,6,178,374,8,560
7,7,7,105,378,5,488
7,7,8,130,436,13,579
7,7,9,113,421,13,547
7,7,A,41,517,15,573
7,7,J,90,428,12,530
7,7,K,109,404,11,524
7,7,Q,99,464,14,577
7,8,10,117,487,11,615
7,8,2,161,405,11,577
7,8,3,162,384,8,554
7,8,4,161,393,7,561
7,8,5,174,383,10,567
7,8,6,182,387,8,577
7,8,7,135,424,11,570
7,8,8,118,423,7,548
7,8,9,125,471,16,612
7,8,A,53,555,14,622
7,8,J,106,434,12,552
7,8,K,131,431,7,569
7,8,Q,91,446,13,550
7,9,10,89,479,10,578
7,9,2,119,445,11,575
7,9,3,146,402,10,558
7,9,4,135,406,2,543
7,9,5,155,393,12,560
7,9,6,175,372,8,555
7,9,7,127,423,10,560
7,9,8,106,459,9,574
7,9,9,80,409,12,501
7,9,A,45,496,20,561
7,9,J,96,464,14,574
7,9,K,108,459,13,580
7,9,Q,90,481,10,581
7,A,10,177,344,53,574
7,A,2,253,235,59,547
7,A,3,277,242,65,584
7,A,4,262,233,59,554
7,A,5,274,212,62,548
7,A,6,308,219,52,579
7,A,7,303,202,49,554
7,A,8,228,250,130,608
7,A,9,203,305,55,563
7,A,A,94,345,66,505
7,A,J,203,335,44,582
7,A,K,193,337,58,588
7,A,Q,197,343,49,589
7,J,10,85,428,41,554
7,J,2,148,399,50,597
7,J,3,145,384,52,581
7,J,4,138,386,59,583
7,J,5,171,385,36,592
7,J,6,149,311,49,509
7,J,7,114,326,90,530
7,J,8,114,425,47,586
7,J,9,123,425,36,584
7,J,A,47,463,42,552
7,J,J,91,412,39,542
7,J,K,109,436,41,586
7,J,Q,108,435,32,575
7,K,10,90,464,29,583
7,K,2,141,395,43,579
7,K,3,137,391,51,579
7,K,4,155,363,61,579
7,K,5,166,374,45,585
7,K,6,156,278,56,490
7,K,7,116,288,115,519
7,K,8,109,441,35,585
7,K,9,100,469,42,611
7,K,A,45,467,52,564
7,K,J,80,471,52,603
7,K,K,89,434,34,557
7,K,Q,127,468,40,635
7,Q,10,107,445,41,593
7,Q,2,151,386,49,586
7,Q,3,123,384,46,553
7,Q,4,148,374,40,562
7,Q,5,169,375,47,591
7,Q,6,158,336,61,555
7,Q,7,119,293,98,510
7,Q,8,113,426,54,593
7,Q,9,104,399,50,553
7,Q,A,47,504,55,606
7,Q,J,96,476,45,617
7,Q,K,93,413,39,545
7,Q,Q,93,443,32,568
8,10,10,122,383,48,553
8,10,2,181,362,64,607
8,10,3,177,382,38,597
8,10,4,168,382,43,593
8,10,5,178,399,46,623
8,10,6,175,338,38,551
8,10,7,227,328,43,598
8,10,8,143,287,110,540
8,10,9,132,407,49,588
8,10,A,95,450,65,610
8,10,J,125,402,37,564
8,10,K,119,408,46,573
8,10,Q,128,399,53,580
8,2,10,146,407,28,581
8,2,2,200,346,11,557
8,2,3,193,351,18,562
8,2,4,233,354,17,604
8,2,5,247,317,19,583
8,2,6,219,307,16,542
8,2,7,195,384,18,597
8,2,8,176,377,12,565
8,2,9,169,426,18,613
8,2,A,76,445,14,535
8,2,J,145,404,27,576
8,2,K,151,404,24,579
8,2,Q,139,421,19,579
8,3,10,185,339,20,544
8,3,2,237,320,32,589
8,3,3,208,303,20,531
8,3,4,243,272,23,538
8,3,5,262,295,15,572
8,3,6,254,265,14,533
8,3,7,211,349,15,575
8,3,8,184,341,16,541
8,3,9,200,351,12,563
8,3,A,99,440,49,588
8,3,J,183,388,26,597
8,3,K,194,366,21,581
8,3,Q,161,377,23,561
8,4,10,107,455,11,573
8,4,2,152,424,6,582
8,4,3,163,355,7,525
8,4,4,197,367,8,572
8,4,5,205,382,6,593
8,4,6,173,393,13,579
8,4,7,156,420,13,589
8,4,8,140,406,11,557
8,4,9,121,401,9,531
8,4,A,60,515,19,594
8,4,J,132,422,15,569
8,4,K,97,449,12,558
8,4,Q,108,467,11,586
8,5,10,92,460,14,566
8,5,2,172,384,15,571
8,5,3,167,403,15,585
8,5,4,179,389,15,583
8,5,5,183,392,5,580
8,5,6,178,336,6,520
8,5,7,161,455,8,624
8,5,8,134,377,9,520
8,5,9,129,390,7,526
8,5,A,52,489,12,553
8,5,J,112,460,17,589
8,5,K,106,433,7,546
8,5,Q,115,475,14,604
8,6,10,118,460,20,598
8,6,2,165,437,12,614
8,6,3,175,399,10,584
8,6,4,174,412,10,596
8,6,5,189,432,11,632
8,6,6,174,349,8,531
8,6,7,127,416,6,549
8,6,8,137,400,9,546
8,6,9,108,395,14,517
8,6,A,40,460,18,518
8,6,J,113,457,14,584
8,6,K,100,427,9,536
8,6,Q,134,415,12,561
8,7,10,111,459,11,581
8,7,2,150,432,12,594
8,7,3,164,399,6,569
8,7,4,184,374,11,569
8,7,5,168,385,5,558
8,7,6,174,378,16,568
8,7,7,137,396,7,540
8,7,8,124,417,13,554
8,7,9,117,457,9,583
8,7,A,43,500,21,564
8,7,J,102,505,10,617
8,7,K,108,441,18,567
8,7,Q,93,458,13,564
8,8,10,86,434,14,534
8,8,2,127,394,7,528
8,8,3,140,416,3,559
8,8,4,149,392,4,545
8,8,5,163,352,4,519
8,8,6,174,347,7,528
8,8,7,134,424,9,567
8,8,8,107,361,8,476
8,8,9,128,406,8,542
8,8,A,42,495,19,556
8,8,J,103,417,12,532
8,8,K,98,452,14,564
8,8,Q,105,414,8,527
8,9,10,107,406,37,550
8,9,2,130,393,49,572
8,9,3,151,398,49,598
8,9,4,153,380,46,579
8,9,5,149,370,53,572
8,9,6,156,362,45,563
8,9,7,116,334,135,585
8,9,8,119,389,45,553
8,9,9,118,406,54,578
8,9,A,45,503,62,610
8,9,J,95,439,38,572
8,9,K,102,460,46,608
8,9,Q,95,458,45,598
8,A,10,245,310,68,623
8,A,2,305,182,59,546
8,A,3,348,181,67,596
8,A,4,320,209,71,600
8,A,5,323,213,59,595
8,A,6,350,182,40,572
8,A,7,361,161,36,558
8,A,8,298,181,48,527
8,A,9,254,215,134,603
8,A,A,151,311,72,534
8,A,J,236,280,51,567
8,A,K,198,291,72,561
8,A,Q,224,284,49,557
8,J,10,123,399,37,559
8,J,2,193,351,54,598
8,J,3,171,354,44,569
8,J,4,218,378,30,626
8,J,5,188,308,38,534
8,J,6,227,323,36,586
8,J,7,192,340,46,578
8,J,8,144,294,103,541
8,J,9,141,402,39,582
8,J,A,102,444,40,586
8,J,J,104,393,39,536
8,J,K,121,372,49,542
8,J,Q,127,403,33,563
8,K,10,145,436,39,620
8,K,2,160,357,47,564
8,K,3,194,350,56,600
8,K,4,182,355,38,575
8,K,5,211,348,49,608
8,K,6,183,327,42,552
8,K,7,224,284,44,552
8,K,8,125,311,96,532
8,K,9,134,388,46,568
8,K,A,76,471,47,594
8,K,J,132,433,39,604
8,K,K,122,401,31,554
8,K,Q,149,429,46,624
8,Q,10,121,397,46,564
8,Q,2,164,342,52,558
8,Q,3,175,362,40,577
8,Q,4,192,329,50,571
8,Q,5,178,369,41,588
8,Q,6,218,317,42,577
8,Q,7,232,329,55,616
8,Q,8,137,293,107,537
8,Q,9,142,432,49,623
8,Q,A,68,478,53,599
8,Q,J,134,434,50,618
8,Q,K,97,448,54,599
8,Q,Q,123,412,45,580
9,10,10,144,367,32,543
9,10,2,212,349,45,606
9,10,3,202,323,49,574
9,10,4,223,323,28,574
9,10,5,236,279,44,559
9,10,6,242,287,46,575
9,10,7,263,287,20,570
9,10,8,229,291,45,565
9,10,9,148,256,117,521
9,10,A,115,414,52,581
9,10,J,158,388,40,586
9,10,K,136,392,34,562
9,10,Q,160,386,38,584
9,2,10,160,393,16,569
9,2,2,245,300,16,561
9,2,3,228,340,27,595
9,2,4,236,286,19,541
9,2,5,274,290,17,581
9,2,6,266,284,11,561
9,2,7,214,343,18,575
9,2,8,214,361,13,588
9,2,9,182,337,19,538
9,2,A,90,441,41,572
9,2,J,180,403,25,608
9,2,K,185,367,21,573
9,2,Q,166,389,17,572
9,3,10,121,476,13,610
9,3,2,171,426,10,607
9,3,3,164,336,11,511
9,3,4,187,384,13,584
9,3,5,184,383,23,590
9,3,6,189,369,11,569
9,3,7,159,386,17,562
9,3,8,128,469,12,609
9,3,9,121,405,10,536
9,3,A,49,496,16,561
9,3,J,128,458,14,600
9,3,K,128,428,14,570
9,3,Q,124,429,14,567
9,4,10,108,444,12,564
9,4,2,154,411,12,577
9,4,3,174,393,11,578
9,4,4,168,351,10,529
9,4,5,184,429,14,627
9,4,6,165,378,9,552
9,4,7,144,439,15,598
9,4,8,133,421,6,560
9,4,9,123,406,7,536
9,4,A,51,501,23,575
9,4,J,139,440,12,591
9,4,K,124,425,15,564
9,4,Q,111,480,14,605
9,5,10,102,470,9,581
9,5,2,153,443,9,605
9,5,3,146,386,13,545
9,5,4,173,391,5,569
9,5,5,161,371,3,535
9,5,6,196,368,6,570
9,5,7,132,415,8,555
9,5,8,124,435,11,570
9,5,9,104,451,11,566
9,5,A,48,504,17,569
9,5,J,96,466,11,573
9,5,K,95,436,10,541
9,5,Q,97,459,15,571
9,6,10,95,461,15,571
9,6,2,137,410,6,553
9,6,3,182,371,9,562
9,6,4,175,403,10,588
9,6,5,199,379,6,584
9,6,6,184,341,7,532
9,6,7,138,429,12,579
9,6,8,127,421,13,561
9,6,9,117,427,11,555
9,6,A,54,527,15,596
9,6,J,92,430,14,536
9,6,K,88,471,10,569
9,6,Q,95,446,9,550
9,7,10,97,423,10,530
9,7,2,142,422,13,577
9,7,3,134,429,6,569
9,7,4,156,435,9,600
9,7,5,163,421,10,594
9,7,6,174,402,5,581
9,7,7,117,398,17,532
9,7,8,115,448,15,578
9,7,9,116,426,10,552
9,7,A,45,559,21,625
9,7,J,123,436,7,566
9,7,K,115,454,7,576
9,7,Q,95,433,9,537
9,8,10,106,410,49,565
9,8,2,131,359,39,529
9,8,3,146,363,60,569
9,8,4,154,346,40,540
9,8,5,145,397,52,594
9,8,6,169,349,64,582
9,8,7,131,329,123,583
9,8,8,109,407,38,554
9,8,9,109,389,43,541
9,8,A,50,466,54,570
9,8,J,92,476,27,595
9,8,K,87,433,49,569
9,8,Q,91,454,34,579
9,9,10,102,405,38,545
9,9,2,166,335,33,534
9,9,3,179,322,38,539
9,9,4,187,311,44,542
9,9,5,155,340,43,538
9,9,6,181,278,28,487
9,9,7,234,310,43,587
9,9,8,132,314,101,547
9,9,9,125,322,45,492
9,9,A,87,410,54,551
9,9,J,129,381,31,541
9,9,K,125,373,41,539
9,9,Q,109,378,50,537
9,A,10,261,184,114,559
9,A,2,361,156,45,562
9,A,3,325,157,42,524
9,A,4,371,180,57,608
9,A,5,339,163,48,550
9,A,6,370,152,37,559
9,A,7,402,145,50,597
9,A,8,345,170,40,555
9,A,9,371,151,42,564
9,A,A,212,285,72,569
9,A,J,265,179,123,567
9,A,K,280,190,125,595
9,A,Q,272,187,126,585
9,J,10,152,409,37,598
9,J,2,231,331,48,610
9,J,3,221,333,47,601
9,J,4,236,336,44,616
9,J,5,227,325,56,608
9,J,6,207,302,42,551
9,J,7,245,303,47,595
9,J,8,233,274,47,554
9,J,9,139,290,104,533
9,J,A,127,402,46,575
9,J,J,164,371,38,573
9,J,K,174,362,36,572
9,J,Q,161,432,37,630
9,K,10,176,387,44,607
9,K,2,211,322,45,578
9,K,3,209,306,36,551
9,K,4,188,293,50,531
9,K,5,223,366,43,632
9,K,6,239,293,32,564
9,K,7,256,275,23,554
9,K,8,249,291,42,582
9,K,9,174,279,107,560
9,K,A,113,384,57,554
9,K,J,175,363,35,573
9,K,K,143,391,31,565
9,K,Q,153,423,42,618
9,Q,10,139,388,29,556
9,Q,2,203,323,46,572
9,Q,3,220,332,46,598
9,Q,4,244,332,40,616
9,Q,5,232,352,41,625
9,Q,6,216,299,27,542
9,Q,7,254,312,30,596
9,Q,8,241,279,37,557
9,Q,9,143,301,115,559
9,Q,A,128,440,43,611
9,Q,J,164,394,34,592
9,Q,K,171,374,37,582
9,Q,Q,136,372,43,551
A,10,10,471,0,58,529
A,10,2,533,0,63,596
A,10,3,502,0,67,569
A,10,4,499,0,60,559
A,10,5,475,0,59,534
A,10,6,521,0,47,568
A,10,7,548,0,28,576
A,10,8,502,0,38,540
A,10,9,563,0,36,599
A,10,A,349,0,202,551
A,10,J,480,0,56,536
A,10,K,515,0,71,586
A,10,Q,486,0,73,559
A,2,10,150,419,23,592
A,2,2,206,340,15,561
A,2,3,233,328,21,582
A,2,4,284,325,17,626
A,2,5,249,301,12,562
A,2,6,265,266,10,541
A,2,7,186,361,17,564
A,2,8,185,353,18,556
A,2,9,179,383,26,588
A,2,A,84,406,23,513
A,2,J,163,419,20,602
A,2,K,165,382,19,566
A,2,Q,187,377,21,585
A,3,10,165,369,29,563
A,3,2,233,348,17,598
A,3,3,220,264,19,503
A,3,4,268,302,20,590
A,3,5,267,345,14,626
A,3,6,234,258,13,505
A,3,7,197,400,19,616
A,3,8,186,360,12,558
A,3,9,188,379,20,587
A,3,A,73,432,25,530
A,3,J,145,384,28,557
A,3,K,159,392,13,564
A,3,Q,145,442,31,618
A,4,10,163,384,15,562
A,4,2,238,355,15,608
A,4,3,227,343,15,585
A,4,4,224,305,13,542
A,4,5,265,295,8,568
A,4,6,277,310,19,606
A,4,7,196,382,15,593
A,4,8,162,371,12,545
A,4,9,170,375,23,568
A,4,A,64,447,16,527
A,4,J,168,383,10,561
A,4,K,161,389,26,576
A,4,Q,182,392,26,600
A,5,10,178,394,16,588
A,5,2,233,320,14,567
A,5,3,233,330,20,583
A,5,4,243,356,8,607
A,5,5,245,290,11,546
A,5,6,274,267,16,557
A,5,7,229,417,13,659
A,5,8,158,405,14,577
A,5,9,171,371,21,563
A,5,A,74,470,31,575
A,5,J,155,391,18,564
A,5,K,151,389,20,560
A,5,Q,147,407,18,572
A,6,10,127,350,47,524
A,6,2,224,301,58,583
A,6,3,228,307,66,601
A,6,4,230,294,53,577
A,6,5,253,301,64,618
A,6,6,262,221,63,546
A,6,7,202,254,114,570
A,6,8,177,357,62,596
A,6,9,172,358,45,575
A,6,A,66,439,78,583
A,6,J,137,389,73,599
A,6,K,164,365,81,610
A,6,Q,172,396,71,639
A,7,10,210,321,69,600
A,7,2,263,240,60,563
A,7,3,268,232,66,566
A,7,4,277,240,37,554
A,7,5,338,254,49,641
A,7,6,299,222,42,563
A,7,7,302,180,61,543
A,7,8,226,201,150,577
A,7,9,206,311,57,574
A,7,A,100,339,64,503
A,7,J,169,295,51,515
A,7,K,197,316,58,571
A,7,Q,189,306,58,553
A,8,10,223,302,39,564
A,8,2,292,217,60,569
A,8,3,325,206,39,570
A,8,4,331,175,48,554
A,8,5,348,190,63,601
A,8,6,318,187,49,554
A,8,7,350,172,34,556
A,8,8,303,184,63,550
A,8,9,266,195,131,592
A,8,A,166,312,70,548
A,8,J,224,268,66,558
A,8,K,248,282,48,578
A,8,Q,208,318,58,584
A,9,10,255,171,122,548
A,9,2,356,165,66,587
A,9,3,351,173,60,584
A,9,4,371,142,52,565
A,9,5,357,154,44,555
A,9,6,395,152,45,592
A,9,7,402,166,55,623
A,9,8,377,133,37,547
A,9,9,343,148,48,539
A,9,A,188,278,61,527
A,9,J,279,206,129,614
A,9,K,251,182,106,539
A,9,Q,284,198,129,611
A,A,10,169,349,21,539
A,A,2,222,300,17,539
A,A,3,232,303,28,563
A,A,4,237,269,16,522
A,A,5,230,298,12,540
A,A,6,264,254,11,529
A,A,7,213,304,25,542
A,A,8,190,330,21,541
A,A,9,148,364,16,528
A,A,A,57,413,22,492
A,A,J,163,383,19,565
A,A,K,136,383,19,538
A,A,Q,158,358,20,536
A,J,10,512,0,56,568
A,J,2,487,0,56,543
A,J,3,505,0,67,572
A,J,4,521,0,61,582
A,J,5,510,0,66,576
A,J,6,523,0,55,578
A,J,7,558,0,44,602
A,J,8,516,0,41,557
A,J,9,559,0,38,597
A,J,A,345,0,182,527
A,J,J,496,0,65,561
A,J,K,492,0,66,558
A,J,Q,482,0,71,553
A,K,10,507,0,74,581
A,K,2,514,0,59,573
A,K,3,568,0,68,636
A,K,4,512,0,74,586
A,K,5,510,0,70,580
A,K,6,468,0,52,520
A,K,7,498,0,44,542
A,K,8,525,0,39,564
A,K,9,513,0,34,547
A,K,A,353,0,190,543
A,K,J,467,0,58,525
A,K,K,490,0,58,548
A,K,Q,517,0,63,580
A,Q,10,511,0,64,575
A,Q,2,527,0,82,609
A,Q,3,491,0,67,558
A,Q,4,499,0,66,565
A,Q,5,481,0,70,551
A,Q,6,507,0,56,563
A,Q,7,498,0,35,533
A,Q,8,548,0,40,588
A,Q,9,575,0,35,610
A,Q,A,336,0,197,533
A,Q,J,520,0,59,579
A,Q,K,510,0,65,575
A,Q,Q,468,0,56,524
J,10,10,167,260,83,510
J,10,2,239,301,43,583
J,10,3,228,321,42,591
J,10,4,252,310,34,596
J,10,5,225,279,27,531
J,10,6,254,283,29,566
J,10,7,271,295,31,597
J,10,8,265,289,17,571
J,10,9,258,289,40,587
J,10,A,157,351,45,553
J,10,J,181,288,99,568
J,10,K,181,305,95,581
J,10,Q,195,303,99,597
J,2,10,130,428,12,570
J,2,2,177,389,7,573
J,2,3,184,424,13,621
J,2,4,170,408,7,585
J,2,5,178,374,9,561
J,2,6,183,356,4,543
J,2,7,170,462,14,646
J,2,8,146,427,9,582
J,2,9,124,450,13,587
J,2,A,50,528,29,607
J,2,J,120,395,14,529
J,2,K,107,447,17,571
J,2,Q,124,462,17,603
J,3,10,123,458,11,592
J,3,2,151,411,10,572
J,3,3,145,386,8,539
J,3,4,180,384,9,573
J,3,5,182,382,5,569
J,3,6,192,405,6,603
J,3,7,148,413,11,572
J,3,8,142,422,8,572
J,3,9,120,475,4,599
J,3,A,50,499,19,568
J,3,J,114,425,14,553
J,3,K,107,473,9,589
J,3,Q,113,480,15,608
J,4,10,126,403,9,538
J,4,2,181,416,4,601
J,4,3,162,431,15,608
J,4,4,172,383,10,565
J,4,5,186,403,8,597
J,4,6,177,373,6,556
J,4,7,149,443,11,603
J,4,8,120,428,11,559
J,4,9,112,452,12,576
J,4,A,53,528,20,601
J,4,J,115,468,12,595
J,4,K,94,452,15,561
J,4,Q,108,454,12,574
J,5,10,103,468,14,585
J,5,2,165,431,9,605
J,5,3,152,444,8,604
J,5,4,174,399,17,590
J,5,5,161,392,13,566
J,5,6,170,379,7,556
J,5,7,142,445,15,602
J,5,8,106,430,11,547
J,5,9,124,461,6,591
J,5,A,34,517,18,569
J,5,J,96,419,11,526
J,5,K,120,445,14,579
J,5,Q,93,484,12,589
J,6,10,102,463,7,572
J,6,2,152,406,6,564
J,6,3,151,418,8,577
J,6,4,160,438,15,613
J,6,5,167,384,11,562
J,6,6,143,377,10,530
J,6,7,137,446,15,598
J,6,8,109,474,14,597
J,6,9,114,461,6,581
J,6,A,48,514,15,577
J,6,J,96,430,12,538
J,6,K,116,443,13,572
J,6,Q,115,458,13,586
J,7,10,109,436,40,585
J,7,2,154,409,56,619
J,7,3,132,425,47,604
J,7,4,153,359,46,558
J,7,5,169,414,46,629
J,7,6,150,330,56,536
J,7,7,123,299,117,539
J,7,8,122,407,53,582
J,7,9,95,411,47,553
J,7,A,46,455,58,559
J,7,J,88,428,37,553
J,7,K,105,444,49,598
J,7,Q,103,501,39,643
J,8,10,144,431,48,623
J,8,2,164,358,46,568
J,8,3,175,367,37,579
J,8,4,208,341,44,593
J,8,5,175,337,46,558
J,8,6,196,349,40,585
J,8,7,240,336,44,620
J,8,8,133,304,81,518
J,8,9,151,432,39,622
J,8,A,82,413,59,554
J,8,J,130,345,42,517
J,8,K,129,414,42,585
J,8,Q,107,441,38,586
J,9,10,153,362,35,550
J,9,2,220,317,41,578
J,9,3,218,337,44,599
J,9,4,233,349,39,621
J,9,5,217,320,28,565
J,9,6,224,307,41,572
J,9,7,261,312,26,599
J,9,8,258,286,36,580
J,9,9,137,296,107,540
J,9,A,134,408,67,609
J,9,J,130,362,38,530
J,9,K,163,389,41,593
J,9,Q,178,394,42,614
J,A,10,516,0,59,575
J,A,2,475,0,65,540
J,A,3,469,0,81,550
J,A,4,522,0,56,578
J,A,5,510,0,61,571
J,A,6,528,0,61,589
J,A,7,575,0,48,623
J,A,8,541,0,48,589
J,A,9,545,0,41,586
J,A,A,330,0,192,522
J,A,J,484,0,48,532
J,A,K,506,0,53,559
J,A,Q,555,0,73,628
J,J,10,149,309,95,553
J,J,2,233,287,36,556
J,J,3,231,296,47,574
J,J,4,215,254,43,512
J,J,5,238,279,40,557
J,J,6,224,242,34,500
J,J,7,254,252,25,531
J,J,8,262,273,23,558
J,J,9,257,244,39,540
J,J,A,120,361,34,515
J,J,J,163,232,84,479
J,J,K,168,273,90,531
J,J,Q,161,288,96,545
J,K,10,181,294,87,562
J,K,2,245,298,45,588
J,K,3,247,326,30,603
J,K,4,278,283,43,604
J,K,5,243,280,41,564
J,K,6,269,283,29,581
J,K,7,261,270,35,566
J,K,8,262,282,35,579
J,K,9,246,272,49,567
J,K,A,144,394,60,598
J,K,J,185,327,82,594
J,K,K,196,317,99,612
J,K,Q,156,319,99,574
J,Q,10,204,296,99,599
J,Q,2,248,309,42,599
J,Q,3,277,323,36,636
J,Q,4,235,305,37,577
J,Q,5,235,303,35,573
J,Q,6,258,279,27,564
J,Q,7,265,302,33,600
J,Q,8,270,271,24,565
J,Q,9,258,318,33,609
J,Q,A,149,369,54,572
J,Q,J,171,292,95,558
J,Q,K,160,278,88,526
J,Q,Q,200,278,107,585
K,10,10,150,264,88,502
K,10,2,231,287,35,553
K,10,3,232,325,38,595
K,10,4,238,318,29,585
K,10,5,258,332,36,626
K,10,6,234,312,28,574
K,10,7,250,310,32,592
K,10,8,270,284,33,587
K,10,9,263,317,42,622
K,10,A,152,345,53,550
K,10,J,181,302,91,574
K,10,K,148,246,107,501
K,10,Q,177,325,97,599
K,2,10,118,414,16,548
K,2,2,173,371,10,554
K,2,3,191,416,5,612
K,2,4,175,379,15,569
K,2,5,182,384,12,578
K,2,6,194,365,8,567
K,2,7,144,437,12,593
K,2,8,147,410,7,564
K,2,9,139,433,11,583
K,2,A,45,536,18,599
K,2,J,119,470,12,601
K,2,K,102,417,14,533
K,2,Q,97,442,12,551
K,3,10,122,461,20,603
K,3,2,163,409,12,584
K,3,3,169,375,11,555
K,3,4,175,385,12,572
K,3,5,187,380,11,578
K,3,6,205,365,10,580
K,3,7,161,428,14,603
K,3,8,130,423,7,560
K,3,9,129,462,11,602
K,3,A,52,540,13,605
K,3,J,127,452,13,592
K,3,K,124,395,12,531
K,3,Q,121,444,15,580
K,4,10,101,471,6,578
K,4,2,161,413,10,584
K,4,3,156,363,15,534
K,4,4,169,345,8,522
K,4,5,191,395,8,594
K,4,6,177,380,6,563
K,4,7,162,455,10,627
K,4,8,130,461,12,603
K,4,9,135,455,8,598
K,4,A,47,510,25,582
K,4,J,97,473,16,586
K,4,K,116,422,16,554
K,4,Q,115,421,13,549
K,5,10,104,448,16,568
K,5,2,138,424,14,576
K,5,3,139,437,11,587
K,5,4,161,439,12,612
K,5,5,153,342,1,496
K,5,6,168,336,6,510
K,5,7,137,450,10,597
K,5,8,119,440,14,573
K,5,9,116,469,8,593
K,5,A,53,503,16,572
K,5,J,103,469,11,583
K,5,K,96,411,12,519
K,5,Q,100,468,12,580
K,6,10,84,420,16,520
K,6,2,134,396,6,536
K,6,3,143,475,20,638
K,6,4,171,406,11,588
K,6,5,162,412,7,581
K,6,6,160,365,8,533
K,6,7,110,433,11,554
K,6,8,109,453,16,578
K,6,9,111,401,9,521
K,6,A,49,524,19,592
K,6,J,105,470,9,584
K,6,K,91,439,9,539
K,6,Q,97,436,21,554
K,7,10,88,432,42,562
K,7,2,152,337,41,530
K,7,3,139,403,47,589
K,7,4,136,382,39,557
K,7,5,156,365,39,560
K,7,6,170,332,66,568
K,7,7,121,309,116,546
K,7,8,109,380,52,541
K,7,9,98,422,24,544
K,7,A,49,437,53,539
K,7,J,95,384,44,523
K,7,K,99,444,47,590
K,7,Q,92,431,33,556
K,8,10,140,411,35,586
K,8,2,154,353,49,556
K,8,3,198,334,45,577
K,8,4,176,358,41,575
K,8,5,186,332,49,567
K,8,6,224,335,41,600
K,8,7,243,292,44,579
K,8,8,131,337,104,572
K,8,9,144,390,39,573
K,8,A,91,450,44,585
K,8,J,126,427,49,602
K,8,K,135,382,29,546
K,8,Q,126,399,37,562
K,9,10,162,384,56,602
K,9,2,203,342,36,581
K,9,3,197,320,47,564
K,9,4,218,300,31,549
K,9,5,218,279,37,534
K,9,6,238,305,39,582
K,9,7,266,299,23,588
K,9,8,223,274,40,537
K,9,9,166,263,110,539
K,9,A,108,410,49,567
K,9,J,173,403,45,621
K,9,K,154,325,37,516
K,9,Q,136,379,30,545
K,A,10,539,0,67,606
K,A,2,491,0,68,559
K,A,3,493,0,81,574
K,A,4,527,0,57,584
K,A,5,507,0,68,575
K,A,6,538,0,42,580
K,A,7,517,0,42,559
K,A,8,559,0,40,599
K,A,9,572,0,33,605
K,A,A,355,0,199,554
K,A,J,554,0,69,623
K,A,K,450,0,55,505
K,A,Q,542,0,62,604
K,J,10,174,278,79,531
K,J,2,259,312,33,604
K,J,3,230,288,36,554
K,J,4,249,283,38,570
K,J,5,242,308,49,599
K,J,6,246,264,39,549
K,J,7,240,275,23,538
K,J,8,265,306,11,582
K,J,9,231,286,33,550
K,J,A,170,382,53,605
K,J,J,160,300,85,545
K,J,K,147,241,87,475
K,J,Q,192,327,105,624
K,K,10,163,313,84,560
K,K,2,209,300,30,539
K,K,3,233,254,43,530
K,K,4,218,297,33,548
K,K,5,252,295,36,583
K,K,6,209,260,26,495
K,K,7,258,295,27,580
K,K,8,247,259,11,517
K,K,9,208,251,24,483
K,K,A,140,374,45,559
K,K,J,192,242,105,539
K,K,K,143,225,72,440
K,K,Q,186,303,89,578
K,Q,10,155,306,100,561
K,Q,2,225,309,42,576
K,Q,3,226,327,42,595
K,Q,4,246,272,42,560
K,Q,5,257,292,34,583
K,Q,6,256,284,28,568
K,Q,7,260,282,21,563
K,Q,8,267,268,17,552
K,Q,9,273,255,51,579
K,Q,A,157,387,47,591
K,Q,J,183,308,100,591
K,Q,K,164,267,83,514
K,Q,Q,169,312,91,572
Q,10,10,159,277,97,533
Q,10,2,263,320,47,630
Q,10,3,247,302,35,584
Q,10,4,232,290,37,559
Q,10,5,254,320,36,610
Q,10,6,227,268,31,526
Q,10,7,301,296,30,627
Q,10,8,249,312,27,588
Q,10,9,263,304,38,605
Q,10,A,168,380,61,609
Q,10,J,174,287,107,568
Q,10,K,194,318,106,618
Q,10,Q,172,280,89,541
Q,2,10,128,448,23,599
Q,2,2,126,382,13,521
Q,2,3,158,383,8,549
Q,2,4,186,350,10,546
Q,2,5,214,366,15,595
Q,2,6,192,355,9,556
Q,2,7,129,419,7,555
Q,2,8,121,437,14,572
Q,2,9,113,415,10,538
Q,2,A,50,488,17,555
Q,2,J,126,442,9,577
Q,2,K,123,432,13,568
Q,2,Q,117,434,11,562
Q,3,10,101,508,15,624
Q,3,2,166,396,6,568
Q,3,3,145,361,13,519
Q,3,4,176,396,8,580
Q,3,5,158,375,11,544
Q,3,6,195,342,13,550
Q,3,7,141,451,8,600
Q,3,8,134,420,8,562
Q,3,9,117,436,16,569
Q,3,A,48,513,18,579
Q,3,J,126,475,14,615
Q,3,K,107,434,23,564
Q,3,Q,114,419,9,542
Q,4,10,104,442,18,564
Q,4,2,165,422,9,596
Q,4,3,179,389,13,581
Q,4,4,177,367,13,557
Q,4,5,167,408,12,587
Q,4,6,205,359,9,573
Q,4,7,121,427,14,562
Q,4,8,145,434,12,591
Q,4,9,119,460,12,591
Q,4,A,33,489,21,543
Q,4,J,128,463,5,596
Q,4,K,103,461,17,581
Q,4,Q,78,403,17,498
Q,5,10,91,449,18,558
Q,5,2,157,385,13,555
Q,5,3,135,414,18,567
Q,5,4,165,405,14,584
Q,5,5,166,401,7,574
Q,5,6,196,394,10,600
Q,5,7,153,431,8,592
Q,5,8,128,419,8,555
Q,5,9,105,459,9,573
Q,5,A,45,516,18,579
Q,5,J,105,483,18,606
Q,5,K,104,477,19,600
Q,5,Q,115,410,7,532
Q,6,10,106,492,12,610
Q,6,2,147,419,8,574
Q,6,3,123,412,11,546
Q,6,4,157,405,14,576
Q,6,5,160,396,13,569
Q,6,6,168,333,15,516
Q,6,7,164,419,7,590
Q,6,8,117,445,11,573
Q,6,9,110,513,12,635
Q,6,A,58,548,16,622
Q,6,J,88,480,14,582
Q,6,K,103,415,11,529
Q,6,Q,100,407,12,519
Q,7,10,98,423,39,560
Q,7,2,150,417,52,619
Q,7,3,130,383,46,559
Q,7,4,163,379,42,584
Q,7,5,167,380,52,599
Q,7,6,163,353,54,570
Q,7,7,117,321,108,546
Q,7,8,119,432,51,602
Q,7,9,108,439,57,604
Q,7,A,33,474,49,556
Q,7,J,99,469,44,612
Q,7,K,105,446,41,592
Q,7,Q,95,406,39,540
Q,8,10,133,399,25,557
Q,8,2,145,348,46,539
Q,8,3,165,362,48,575
Q,8,4,164,346,40,550
Q,8,5,204,348,44,596
Q,8,6,178,315,33,526
Q,8,7,228,310,50,588
Q,8,8,151,324,97,572
Q,8,9,151,408,35,594
Q,8,A,83,435,59,577
Q,8,J,114,413,43,570
Q,8,K,134,413,41,588
Q,8,Q,112,418,41,571
Q,9,10,166,355,56,577
Q,9,2,203,305,42,550
Q,9,3,206,326,39,571
Q,9,4,234,298,46,578
Q,9,5,229,346,30,605
Q,9,6,208,302,31,541
Q,9,7,276,259,21,556
Q,9,8,250,272,47,569
Q,9,9,175,278,113,566
Q,9,A,103,432,59,594
Q,9,J,154,364,31,549
Q,9,K,161,394,48,603
Q,9,Q,129,358,44,531
Q,A,10,517,0,50,567
Q,A,2,555,0,59,614
Q,A,3,527,0,55,582
Q,A,4,527,0,62,589
Q,A,5,512,0,68,580
Q,A,6,473,0,43,516
Q,A,7,547,0,38,585
Q,A,8,532,0,35,567
Q,A,9,523,0,38,561
Q,A,A,312,0,229,541
Q,A,J,487,0,70,557
Q,A,K,498,0,59,557
Q,A,Q,465,0,50,515
Q,J,10,161,297,86,544
Q,J,2,252,319,36,607
Q,J,3,242,288,39,569
Q,J,4,256,275,33,564
Q,J,5,248,312,25,585
Q,J,6,227,272,33,532
Q,J,7,241,284,17,542
Q,J,8,290,271,21,582
Q,J,9,246,269,40,555
Q,J,A,148,357,42,547
Q,J,J,174,289,105,568
Q,J,K,158,304,85,547
Q,J,Q,155,275,122,552
Q,K,10,167,302,88,557
Q,K,2,223,314,46,583
Q,K,3,257,316,35,608
Q,K,4,228,263,33,524
Q,K,5,254,347,38,639
Q,K,6,243,275,30,548
Q,K,7,271,294,25,590
Q,K,8,258,243,23,524
Q,K,9,283,294,33,610
Q,K,A,174,352,46,572
Q,K,J,185,324,110,619
Q,K,K,150,304,88,542
Q,K,Q,176,306,99,581
Q,Q,10,183,271,106,560
Q,Q,2,229,281,38,548
Q,Q,3,203,259,38,500
Q,Q,4,223,273,40,536
Q,Q,5,249,280,38,567
Q,Q,6,222,280,19,521
Q,Q,7,258,256,31,545
Q,Q,8,236,274,18,528
Q,Q,9,229,254,34,517
Q,Q,A,147,346,45,538
Q,Q,J,178,275,88,541
Q,Q,K,173,261,71,505
Q,Q,Q,159,247,61,467
