PlayerCard1,PlayerCard2,DealerHand,PlayerChoices,Win,Lost,Push,Total
10,10,10,double,681,8779,78,9538
10,10,10,hit,338,4308,33,4679
10,10,10,stay,7727,1660,4761,14148
10,10,2,double,179,2191,29,2399
10,10,2,hit,84,1096,9,1189
10,10,2,stay,2660,453,493,3606
10,10,3,double,197,2232,27,2456
10,10,3,hit,80,1090,7,1177
10,10,3,stay,2733,443,466,3642
10,10,4,double,157,2286,29,2472
10,10,4,hit,77,1173,12,1262
10,10,4,stay,2773,432,500,3705
10,10,5,double,163,2294,25,2482
10,10,5,hit,82,1148,11,1241
10,10,5,stay,2807,391,454,3652
10,10,6,double,180,2247,24,2451
10,10,6,hit,65,1145,8,1218
10,10,6,stay,2810,391,386,3587
10,10,7,double,151,2282,13,2446
10,10,7,hit,69,1159,6,1234
10,10,7,stay,3148,283,266,3697
10,10,8,double,177,2185,15,2377
10,10,8,hit,99,1154,4,1257
10,10,8,stay,3094,256,265,3615
10,10,9,double,167,2203,10,2380
10,10,9,hit,77,1095,8,1180
10,10,9,stay,3031,213,437,3681
10,10,A,double,99,2277,68,2444
10,10,A,hit,49,1142,40,1231
10,10,A,stay,1744,1290,447,3481
10,2,10,double,503,1785,120,2408
10,2,10,hit,246,920,50,1216
10,2,10,stay,761,3026,0,3787
10,2,2,double,150,398,30,578
10,2,2,hit,64,218,14,296
10,2,2,stay,293,543,0,836
10,2,3,double,158,447,31,636
10,2,3,hit,74,227,4,305
10,2,3,stay,306,656,0,962
10,2,4,double,170,461,16,647
10,2,4,hit,85,216,14,315
10,2,4,stay,339,572,0,911
10,2,5,double,180,403,24,607
10,2,5,hit,80,213,9,302
10,2,5,stay,380,553,0,933
10,2,6,double,194,444,18,656
10,2,6,hit,93,220,9,322
10,2,6,stay,365,543,0,908
10,2,7,double,156,402,30,588
10,2,7,hit,86,213,17,316
10,2,7,stay,226,719,0,945
10,2,8,double,175,463,26,664
10,2,8,hit,72,215,12,299
10,2,8,stay,212,742,0,954
10,2,9,double,141,432,20,593
10,2,9,hit,75,241,14,330
10,2,9,stay,203,723,0,926
10,2,A,double,73,504,47,624
10,2,A,hit,34,268,21,323
10,2,A,stay,54,838,0,892
10,3,10,double,448,1854,110,2412
10,3,10,hit,264,906,58,1228
10,3,10,stay,709,2909,0,3618
10,3,2,double,139,444,33,616
10,3,2,hit,68,213,13,294
10,3,2,stay,284,592,0,876
10,3,3,double,123,376,18,517
10,3,3,hit,56,194,13,263
10,3,3,stay,289,576,0,865
10,3,4,double,163,470,26,659
10,3,4,hit,81,262,10,353
10,3,4,stay,336,560,0,896
10,3,5,double,158,450,28,636
10,3,5,hit,79,209,8,296
10,3,5,stay,359,548,0,907
10,3,6,double,149,420,27,596
10,3,6,hit,80,235,9,324
10,3,6,stay,394,581,0,975
10,3,7,double,154,455,32,641
10,3,7,hit,78,241,12,331
10,3,7,stay,212,685,0,897
10,3,8,double,140,441,25,606
10,3,8,hit,68,223,11,302
10,3,8,stay,192,696,0,888
10,3,9,double,109,475,23,607
10,3,9,hit,69,256,14,339
10,3,9,stay,206,749,0,955
10,3,A,double,78,475,43,596
10,3,A,hit,33,262,12,307
10,3,A,stay,45,891,0,936
10,4,10,double,400,1832,108,2340
10,4,10,hit,210,978,52,1240
10,4,10,stay,743,2924,0,3667
10,4,2,double,114,425,17,556
10,4,2,hit,68,252,15,335
10,4,2,stay,308,655,0,963
10,4,3,double,153,458,23,634
10,4,3,hit,67,216,10,293
10,4,3,stay,304,565,0,869
10,4,4,double,126,442,18,586
10,4,4,hit,82,205,7,294
10,4,4,stay,330,495,0,825
10,4,5,double,153,441,22,616
10,4,5,hit,58,208,6,272
10,4,5,stay,370,565,0,935
10,4,6,double,155,419,17,591
10,4,6,hit,71,231,8,310
10,4,6,stay,369,562,0,931
10,4,7,double,115,483,32,630
10,4,7,hit,60,230,12,302
10,4,7,stay,256,683,0,939
10,4,8,double,127,472,28,627
10,4,8,hit,64,212,11,287
10,4,8,stay,211,675,0,886
10,4,9,double,128,471,24,623
10,4,9,hit,62,245,6,313
10,4,9,stay,222,742,0,964
10,4,A,double,73,533,31,637
10,4,A,hit,36,252,18,306
10,4,A,stay,38,888,0,926
10,5,10,double,411,1926,105,2442
10,5,10,hit,198,976,51,1225
10,5,10,stay,741,2840,0,3581
10,5,2,double,107,478,27,612
10,5,2,hit,54,232,10,296
10,5,2,stay,299,606,0,905
10,5,3,double,121,490,23,634
10,5,3,hit,52,230,9,291
10,5,3,stay,309,589,0,898
10,5,4,double,142,477,24,643
10,5,4,hit,62,204,6,272
10,5,4,stay,349,635,0,984
10,5,5,double,109,462,20,591
10,5,5,hit,52,221,10,283
10,5,5,stay,355,527,0,882
10,5,6,double,118,462,19,599
10,5,6,hit,60,238,10,308
10,5,6,stay,427,558,0,985
10,5,7,double,134,480,24,638
10,5,7,hit,73,248,10,331
10,5,7,stay,225,662,0,887
10,5,8,double,114,430,19,563
10,5,8,hit,62,241,14,317
10,5,8,stay,240,738,0,978
10,5,9,double,111,504,28,643
10,5,9,hit,54,240,11,305
10,5,9,stay,196,744,0,940
10,5,A,double,69,506,32,607
10,5,A,hit,33,251,24,308
10,5,A,stay,41,887,0,928
10,6,10,double,378,1998,102,2478
10,6,10,hit,172,929,41,1142
10,6,10,stay,732,2966,0,3698
10,6,2,double,107,451,23,581
10,6,2,hit,55,218,14,287
10,6,2,stay,289,624,0,913
10,6,3,double,106,482,24,612
10,6,3,hit,49,237,12,298
10,6,3,stay,322,625,0,947
10,6,4,double,104,492,17,613
10,6,4,hit,45,220,15,280
10,6,4,stay,341,618,0,959
10,6,5,double,116,470,18,604
10,6,5,hit,59,239,7,305
10,6,5,stay,359,551,0,910
10,6,6,double,108,456,18,582
10,6,6,hit,61,206,8,275
10,6,6,stay,331,523,0,854
10,6,7,double,128,493,24,645
10,6,7,hit,67,248,14,329
10,6,7,stay,223,721,0,944
10,6,8,double,109,487,25,621
10,6,8,hit,60,243,11,314
10,6,8,stay,191,709,0,900
10,6,9,double,87,479,27,593
10,6,9,hit,66,239,11,316
10,6,9,stay,203,779,0,982
10,6,A,double,64,516,33,613
10,6,A,hit,26,278,14,318
10,6,A,stay,47,849,0,896
10,7,10,double,307,1917,81,2305
10,7,10,hit,166,933,57,1156
10,7,10,stay,704,2364,373,3441
10,7,2,double,101,452,16,569
10,7,2,hit,44,256,11,311
10,7,2,stay,266,500,137,903
10,7,3,double,95,460,14,569
10,7,3,hit,45,245,13,303
10,7,3,stay,321,465,137,923
10,7,4,double,93,504,14,611
10,7,4,hit,53,253,6,312
10,7,4,stay,354,454,132,940
10,7,5,double,106,475,15,596
10,7,5,hit,46,233,7,286
10,7,5,stay,365,457,113,935
10,7,6,double,112,507,5,624
10,7,6,hit,46,255,10,311
10,7,6,stay,381,369,155,905
10,7,7,double,120,475,11,606
10,7,7,hit,48,223,3,274
10,7,7,stay,227,323,326,876
10,7,8,double,103,477,29,609
10,7,8,hit,53,248,13,314
10,7,8,stay,239,581,113,933
10,7,9,double,99,538,22,659
10,7,9,hit,47,237,13,297
10,7,9,stay,206,627,110,943
10,7,A,double,67,498,39,604
10,7,A,hit,35,265,18,318
10,7,A,stay,44,765,140,949
10,8,10,double,292,2093,61,2446
10,8,10,hit,155,985,37,1177
10,8,10,stay,1212,1990,379,3581
10,8,2,double,84,520,12,616
10,8,2,hit,36,247,6,289
10,8,2,stay,402,366,119,887
10,8,3,double,77,506,17,600
10,8,3,hit,52,256,5,313
10,8,3,stay,466,357,106,929
10,8,4,double,99,579,16,694
10,8,4,hit,55,269,5,329
10,8,4,stay,466,353,119,938
10,8,5,double,90,523,12,625
10,8,5,hit,54,262,8,324
10,8,5,stay,486,323,108,917
10,8,6,double,121,498,12,631
10,8,6,hit,42,252,3,297
10,8,6,stay,524,282,97,903
10,8,7,double,92,556,8,656
10,8,7,hit,60,267,5,332
10,8,7,stay,578,198,136,912
10,8,8,double,83,493,19,595
10,8,8,hit,61,248,1,310
10,8,8,stay,312,252,305,869
10,8,9,double,76,530,10,616
10,8,9,hit,39,254,12,305
10,8,9,stay,313,520,118,951
10,8,A,double,43,498,25,566
10,8,A,hit,30,292,14,336
10,8,A,stay,184,603,121,908
10,9,10,double,259,2060,65,2384
10,9,10,hit,118,1033,38,1189
10,9,10,stay,1565,1646,424,3635
10,9,2,double,74,538,10,622
10,9,2,hit,41,276,8,325
10,9,2,stay,553,231,138,922
10,9,3,double,75,574,5,654
10,9,3,hit,44,271,4,319
10,9,3,stay,556,243,111,910
10,9,4,double,57,589,13,659
10,9,4,hit,42,254,2,298
10,9,4,stay,592,217,127,936
10,9,5,double,65,546,8,619
10,9,5,hit,36,272,6,314
10,9,5,stay,571,205,127,903
10,9,6,double,96,526,6,628
10,9,6,hit,33,288,8,329
10,9,6,stay,592,215,100,907
10,9,7,double,76,530,12,618
10,9,7,hit,35,268,2,305
10,9,7,stay,712,143,63,918
10,9,8,double,60,535,6,601
10,9,8,hit,36,256,3,295
10,9,8,stay,626,143,130,899
10,9,9,double,80,506,8,594
10,9,9,hit,35,229,2,266
10,9,9,stay,416,161,337,914
10,9,A,double,42,562,16,620
10,9,A,hit,23,243,6,272
10,9,A,stay,300,480,137,917
10,A,10,blackjack,6536,0,798,7334
10,A,2,blackjack,1552,0,212,1764
10,A,3,blackjack,1669,0,216,1885
10,A,4,blackjack,1745,0,208,1953
10,A,5,blackjack,1706,0,215,1921
10,A,6,blackjack,1704,0,177,1881
10,A,7,blackjack,1842,0,149,1991
10,A,8,blackjack,1709,0,124,1833
10,A,9,blackjack,1761,0,106,1867
10,A,A,blackjack,1071,0,671,1742
2,10,10,double,477,1834,118,2429
2,10,10,hit,244,938,67,1249
2,10,10,stay,770,2899,0,3669
2,10,2,double,133,433,15,581
2,10,2,hit,81,179,7,267
2,10,2,stay,285,569,0,854
2,10,3,double,161,467,15,643
2,10,3,hit,86,205,11,302
2,10,3,stay,307,625,0,932
2,10,4,double,175,453,22,650
2,10,4,hit,77,200,9,286
2,10,4,stay,335,612,0,947
2,10,5,double,170,456,26,652
2,10,5,hit,78,215,7,300
2,10,5,stay,351,548,0,899
2,10,6,double,180,425,30,635
2,10,6,hit,82,246,14,342
2,10,6,stay,363,522,0,885
2,10,7,double,178,456,19,653
2,10,7,hit,83,204,14,301
2,10,7,stay,217,735,0,952
2,10,8,double,159,431,28,618
2,10,8,hit,80,197,12,289
2,10,8,stay,207,723,0,930
2,10,9,double,130,442,21,593
2,10,9,hit,72,216,19,307
2,10,9,stay,206,716,0,922
2,10,A,double,91,496,48,635
2,10,A,hit,37,242,12,291
2,10,A,stay,48,853,0,901
2,2,10,double,97,445,17,559
2,2,10,hit,66,213,8,287
2,2,10,stay,170,697,0,867
2,2,2,double,42,83,3,128
2,2,2,hit,22,56,2,80
2,2,2,stay,45,125,0,170
2,2,3,double,50,87,2,139
2,2,3,hit,24,51,1,76
2,2,3,stay,82,124,0,206
2,2,4,double,38,79,2,119
2,2,4,hit,25,51,1,77
2,2,4,stay,57,113,0,170
2,2,5,double,53,103,3,159
2,2,5,hit,30,42,5,77
2,2,5,stay,95,138,0,233
2,2,6,double,76,83,5,164
2,2,6,hit,20,36,1,57
2,2,6,stay,66,118,0,184
2,2,7,double,36,97,3,136
2,2,7,hit,20,56,0,76
2,2,7,stay,61,134,0,195
2,2,8,double,36,87,4,127
2,2,8,hit,24,51,2,77
2,2,8,stay,52,161,0,213
2,2,9,double,31,105,5,141
2,2,9,hit,16,62,3,81
2,2,9,stay,53,161,0,214
2,2,A,double,11,114,6,131
2,2,A,hit,7,52,3,62
2,2,A,stay,8,202,0,210
2,3,10,double,145,489,21,655
2,3,10,hit,71,200,12,283
2,3,10,stay,195,741,0,936
2,3,2,double,48,114,2,164
2,3,2,hit,21,55,0,76
2,3,2,stay,73,153,0,226
2,3,3,double,47,96,0,143
2,3,3,hit,14,50,2,66
2,3,3,stay,81,143,0,224
2,3,4,double,53,125,4,182
2,3,4,hit,32,58,1,91
2,3,4,stay,87,157,0,244
2,3,5,double,48,86,3,137
2,3,5,hit,20,42,0,62
2,3,5,stay,93,150,0,243
2,3,6,double,60,90,3,153
2,3,6,hit,28,41,1,70
2,3,6,stay,118,156,0,274
2,3,7,double,39,91,3,133
2,3,7,hit,16,47,3,66
2,3,7,stay,55,166,0,221
2,3,8,double,35,111,3,149
2,3,8,hit,25,50,1,76
2,3,8,stay,49,180,0,229
2,3,9,double,36,109,2,147
2,3,9,hit,23,49,5,77
2,3,9,stay,45,154,0,199
2,3,A,double,18,116,7,141
2,3,A,hit,10,56,0,66
2,3,A,stay,16,190,0,206
2,4,10,double,130,466,27,623
2,4,10,hit,74,216,6,296
2,4,10,stay,192,735,0,927
2,4,2,double,34,108,6,148
2,4,2,hit,19,38,1,58
2,4,2,stay,61,156,0,217
2,4,3,double,53,95,5,153
2,4,3,hit,23,65,1,89
2,4,3,stay,67,153,0,220
2,4,4,double,43,112,1,156
2,4,4,hit,18,56,7,81
2,4,4,stay,95,153,0,248
2,4,5,double,48,90,3,141
2,4,5,hit,29,48,1,78
2,4,5,stay,102,139,0,241
2,4,6,double,63,87,2,152
2,4,6,hit,27,49,0,76
2,4,6,stay,101,158,0,259
2,4,7,double,48,97,5,150
2,4,7,hit,23,44,2,69
2,4,7,stay,64,177,0,241
2,4,8,double,41,119,2,162
2,4,8,hit,13,56,2,71
2,4,8,stay,52,177,0,229
2,4,9,double,27,96,8,131
2,4,9,hit,19,68,2,89
2,4,9,stay,55,175,0,230
2,4,A,double,14,131,2,147
2,4,A,hit,8,72,2,82
2,4,A,stay,19,222,0,241
2,5,10,double,112,457,32,601
2,5,10,hit,72,216,13,301
2,5,10,stay,194,709,0,903
2,5,2,double,41,90,6,137
2,5,2,hit,17,48,7,72
2,5,2,stay,66,130,0,196
2,5,3,double,46,82,6,134
2,5,3,hit,23,58,4,85
2,5,3,stay,85,155,0,240
2,5,4,double,45,111,4,160
2,5,4,hit,24,50,6,80
2,5,4,stay,84,139,0,223
2,5,5,double,53,80,2,135
2,5,5,hit,26,42,2,70
2,5,5,stay,73,113,0,186
2,5,6,double,55,96,10,161
2,5,6,hit,20,54,4,78
2,5,6,stay,82,138,0,220
2,5,7,double,49,90,11,150
2,5,7,hit,21,46,9,76
2,5,7,stay,58,157,0,215
2,5,8,double,38,103,7,148
2,5,8,hit,22,49,1,72
2,5,8,stay,50,177,0,227
2,5,9,double,36,105,10,151
2,5,9,hit,16,43,1,60
2,5,9,stay,45,194,0,239
2,5,A,double,15,127,11,153
2,5,A,hit,9,54,5,68
2,5,A,stay,16,219,0,235
2,6,10,double,148,438,25,611
2,6,10,hit,69,207,15,291
2,6,10,stay,200,750,0,950
2,6,2,double,51,75,9,135
2,6,2,hit,17,44,3,64
2,6,2,stay,46,151,0,197
2,6,3,double,58,98,9,165
2,6,3,hit,19,46,3,68
2,6,3,stay,77,149,0,226
2,6,4,double,64,78,9,151
2,6,4,hit,26,41,7,74
2,6,4,stay,82,134,0,216
2,6,5,double,54,89,14,157
2,6,5,hit,18,48,2,68
2,6,5,stay,86,148,0,234
2,6,6,double,62,86,5,153
2,6,6,hit,33,40,4,77
2,6,6,stay,74,142,0,216
2,6,7,double,55,108,13,176
2,6,7,hit,26,52,6,84
2,6,7,stay,71,185,0,256
2,6,8,double,41,92,16,149
2,6,8,hit,23,45,12,80
2,6,8,stay,49,175,0,224
2,6,9,double,43,111,9,163
2,6,9,hit,17,54,6,77
2,6,9,stay,47,194,0,241
2,6,A,double,18,143,8,169
2,6,A,hit,11,59,4,74
2,6,A,stay,10,203,0,213
2,7,10,double,144,422,48,614
2,7,10,hit,88,218,18,324
2,7,10,stay,203,721,0,924
2,7,2,double,56,95,5,156
2,7,2,hit,22,39,4,65
2,7,2,stay,59,148,0,207
2,7,3,double,53,114,15,182
2,7,3,hit,22,48,6,76
2,7,3,stay,93,160,0,253
2,7,4,double,54,95,10,159
2,7,4,hit,27,41,2,70
2,7,4,stay,99,140,0,239
2,7,5,double,45,81,8,134
2,7,5,hit,20,49,4,73
2,7,5,stay,115,132,0,247
2,7,6,double,41,80,7,128
2,7,6,hit,25,41,2,68
2,7,6,stay,86,113,0,199
2,7,7,double,48,88,16,152
2,7,7,hit,32,47,3,82
2,7,7,stay,62,171,0,233
2,7,8,double,46,77,16,139
2,7,8,hit,26,40,3,69
2,7,8,stay,50,173,0,223
2,7,9,double,43,105,13,161
2,7,9,hit,24,46,5,75
2,7,9,stay,45,191,0,236
2,7,A,double,23,102,12,137
2,7,A,hit,9,57,8,74
2,7,A,stay,10,210,0,220
2,8,10,double,198,433,50,681
2,8,10,hit,92,205,21,318
2,8,10,stay,187,765,0,952
2,8,2,double,50,95,6,151
2,8,2,hit,25,48,3,76
2,8,2,stay,81,160,0,241
2,8,3,double,51,70,5,126
2,8,3,hit,37,41,2,80
2,8,3,stay,74,153,0,227
2,8,4,double,66,93,4,163
2,8,4,hit,21,44,2,67
2,8,4,stay,85,149,0,234
2,8,5,double,59,91,11,161
2,8,5,hit,28,41,2,71
2,8,5,stay,103,144,0,247
2,8,6,double,60,75,7,142
2,8,6,hit,33,51,6,90
2,8,6,stay,79,126,0,205
2,8,7,double,67,75,10,152
2,8,7,hit,30,51,2,83
2,8,7,stay,56,171,0,227
2,8,8,double,57,84,4,145
2,8,8,hit,26,47,2,75
2,8,8,stay,52,171,0,223
2,8,9,double,57,79,7,143
2,8,9,hit,21,42,5,68
2,8,9,stay,59,181,0,240
2,8,A,double,34,114,15,163
2,8,A,hit,16,45,4,65
2,8,A,stay,18,194,0,212
2,9,10,double,279,309,55,643
2,9,10,hit,115,138,22,275
2,9,10,stay,188,760,0,948
2,9,2,double,66,72,11,149
2,9,2,hit,30,17,4,51
2,9,2,stay,78,139,0,217
2,9,3,double,80,62,11,153
2,9,3,hit,32,33,6,71
2,9,3,stay,84,138,0,222
2,9,4,double,82,75,10,167
2,9,4,hit,31,31,5,67
2,9,4,stay,95,149,0,244
2,9,5,double,109,60,12,181
2,9,5,hit,38,29,2,69
2,9,5,stay,92,124,0,216
2,9,6,double,86,81,14,181
2,9,6,hit,32,24,4,60
2,9,6,stay,108,146,0,254
2,9,7,double,77,79,10,166
2,9,7,hit,42,39,9,90
2,9,7,stay,62,173,0,235
2,9,8,double,69,71,11,151
2,9,8,hit,44,33,3,80
2,9,8,stay,58,187,0,245
2,9,9,double,80,57,12,149
2,9,9,hit,25,31,5,61
2,9,9,stay,37,163,0,200
2,9,A,double,50,89,18,157
2,9,A,hit,28,45,8,81
2,9,A,stay,13,215,0,228
2,A,10,double,210,372,43,625
2,A,10,hit,97,179,28,304
2,A,10,stay,185,725,0,910
2,A,2,double,63,66,8,137
2,A,2,hit,38,41,2,81
2,A,2,stay,85,134,0,219
2,A,3,double,73,73,6,152
2,A,3,hit,39,39,2,80
2,A,3,stay,90,159,0,249
2,A,4,double,84,77,9,170
2,A,4,hit,28,41,3,72
2,A,4,stay,81,135,0,216
2,A,5,double,80,76,8,164
2,A,5,hit,38,42,2,82
2,A,5,stay,99,136,0,235
2,A,6,double,98,60,9,167
2,A,6,hit,33,30,3,66
2,A,6,stay,89,157,0,246
2,A,7,double,82,84,9,175
2,A,7,hit,28,38,5,71
2,A,7,stay,51,176,0,227
2,A,8,double,60,81,8,149
2,A,8,hit,25,43,7,75
2,A,8,stay,58,179,0,237
2,A,9,double,59,84,9,152
2,A,9,hit,26,38,1,65
2,A,9,stay,46,177,0,223
2,A,A,double,19,118,12,149
2,A,A,hit,7,41,5,53
2,A,A,stay,14,194,0,208
3,10,10,double,481,1866,105,2452
3,10,10,hit,253,928,51,1232
3,10,10,stay,778,2860,0,3638
3,10,2,double,151,416,23,590
3,10,2,hit,84,218,12,314
3,10,2,stay,292,618,0,910
3,10,3,double,131,362,15,508
3,10,3,hit,74,234,14,322
3,10,3,stay,312,532,0,844
3,10,4,double,146,451,23,620
3,10,4,hit,77,238,9,324
3,10,4,stay,312,592,0,904
3,10,5,double,149,437,20,606
3,10,5,hit,66,212,5,283
3,10,5,stay,368,564,0,932
3,10,6,double,157,446,22,625
3,10,6,hit,76,234,8,318
3,10,6,stay,370,516,0,886
3,10,7,double,153,444,16,613
3,10,7,hit,91,227,11,329
3,10,7,stay,202,710,0,912
3,10,8,double,135,454,24,613
3,10,8,hit,77,254,11,342
3,10,8,stay,224,683,0,907
3,10,9,double,135,452,25,612
3,10,9,hit,70,240,11,321
3,10,9,stay,209,719,0,928
3,10,A,double,65,489,46,600
3,10,A,hit,41,241,21,303
3,10,A,stay,66,878,0,944
3,2,10,double,149,469,19,637
3,2,10,hit,68,238,5,311
3,2,10,stay,196,717,0,913
3,2,2,double,41,101,3,145
3,2,2,hit,17,56,3,76
3,2,2,stay,76,153,0,229
3,2,3,double,41,107,1,149
3,2,3,hit,21,43,3,67
3,2,3,stay,69,145,0,214
3,2,4,double,40,93,3,136
3,2,4,hit,32,41,5,78
3,2,4,stay,80,144,0,224
3,2,5,double,44,114,4,162
3,2,5,hit,16,45,4,65
3,2,5,stay,114,154,0,268
3,2,6,double,46,101,3,150
3,2,6,hit,22,53,2,77
3,2,6,stay,84,137,0,221
3,2,7,double,43,103,4,150
3,2,7,hit,20,51,8,79
3,2,7,stay,53,169,0,222
3,2,8,double,41,123,4,168
3,2,8,hit,13,45,2,60
3,2,8,stay,51,177,0,228
3,2,9,double,37,134,1,172
3,2,9,hit,21,61,2,84
3,2,9,stay,46,165,0,211
3,2,A,double,14,126,7,147
3,2,A,hit,8,79,4,91
3,2,A,stay,11,214,0,225
3,3,10,double,116,400,17,533
3,3,10,hit,62,203,13,278
3,3,10,stay,181,665,0,846
3,3,2,double,42,104,2,148
3,3,2,hit,32,59,2,93
3,3,2,stay,62,163,0,225
3,3,3,double,44,82,7,133
3,3,3,hit,17,39,3,59
3,3,3,stay,50,126,0,176
3,3,4,double,39,98,5,142
3,3,4,hit,26,51,1,78
3,3,4,stay,74,151,0,225
3,3,5,double,50,97,4,151
3,3,5,hit,28,44,3,75
3,3,5,stay,83,146,0,229
3,3,6,double,59,98,5,162
3,3,6,hit,28,36,2,66
3,3,6,stay,86,142,0,228
3,3,7,double,39,126,3,168
3,3,7,hit,17,63,4,84
3,3,7,stay,56,164,0,220
3,3,8,double,45,97,4,146
3,3,8,hit,14,53,4,71
3,3,8,stay,57,175,0,232
3,3,9,double,43,115,4,162
3,3,9,hit,24,52,1,77
3,3,9,stay,39,183,0,222
3,3,A,double,13,131,8,152
3,3,A,hit,4,63,2,69
3,3,A,stay,8,181,0,189
3,4,10,double,133,439,25,597
3,4,10,hit,55,219,10,284
3,4,10,stay,207,766,0,973
3,4,2,double,47,105,6,158
3,4,2,hit,22,49,4,75
3,4,2,stay,75,157,0,232
3,4,3,double,44,91,8,143
3,4,3,hit,20,42,6,68
3,4,3,stay,65,148,0,213
3,4,4,double,44,114,4,162
3,4,4,hit,21,58,4,83
3,4,4,stay,91,152,0,243
3,4,5,double,57,99,8,164
3,4,5,hit,24,43,3,70
3,4,5,stay,81,117,0,198
3,4,6,double,60,120,6,186
3,4,6,hit,23,39,5,67
3,4,6,stay,101,138,0,239
3,4,7,double,37,101,17,155
3,4,7,hit,22,47,6,75
3,4,7,stay,56,166,0,222
3,4,8,double,32,111,8,151
3,4,8,hit,23,46,2,71
3,4,8,stay,49,172,0,221
3,4,9,double,34,116,9,159
3,4,9,hit,11,59,5,75
3,4,9,stay,58,161,0,219
3,4,A,double,22,117,8,147
3,4,A,hit,6,59,5,70
3,4,A,stay,8,226,0,234
3,5,10,double,153,431,35,619
3,5,10,hit,58,200,9,267
3,5,10,stay,165,744,0,909
3,5,2,double,53,95,2,150
3,5,2,hit,24,57,1,82
3,5,2,stay,59,120,0,179
3,5,3,double,53,92,6,151
3,5,3,hit,35,49,1,85
3,5,3,stay,69,151,0,220
3,5,4,double,44,115,6,165
3,5,4,hit,30,44,8,82
3,5,4,stay,81,146,0,227
3,5,5,double,57,72,6,135
3,5,5,hit,19,45,3,67
3,5,5,stay,92,140,0,232
3,5,6,double,46,98,2,146
3,5,6,hit,23,42,2,67
3,5,6,stay,94,136,0,230
3,5,7,double,43,94,12,149
3,5,7,hit,28,52,7,87
3,5,7,stay,61,199,0,260
3,5,8,double,51,104,19,174
3,5,8,hit,13,39,7,59
3,5,8,stay,50,174,0,224
3,5,9,double,46,108,10,164
3,5,9,hit,19,53,6,78
3,5,9,stay,44,173,0,217
3,5,A,double,21,111,10,142
3,5,A,hit,7,68,4,79
3,5,A,stay,10,204,0,214
3,6,10,double,132,424,41,597
3,6,10,hit,79,203,23,305
3,6,10,stay,168,679,0,847
3,6,2,double,59,94,5,158
3,6,2,hit,17,49,4,70
3,6,2,stay,63,151,0,214
3,6,3,double,54,91,4,149
3,6,3,hit,26,45,2,73
3,6,3,stay,79,135,0,214
3,6,4,double,57,89,8,154
3,6,4,hit,29,48,4,81
3,6,4,stay,77,122,0,199
3,6,5,double,63,88,8,159
3,6,5,hit,24,47,3,74
3,6,5,stay,87,166,0,253
3,6,6,double,49,78,3,130
3,6,6,hit,29,39,5,73
3,6,6,stay,88,126,0,214
3,6,7,double,44,83,2,129
3,6,7,hit,34,46,1,81
3,6,7,stay,53,166,0,219
3,6,8,double,39,109,11,159
3,6,8,hit,39,51,4,94
3,6,8,stay,59,158,0,217
3,6,9,double,49,105,20,174
3,6,9,hit,31,62,3,96
3,6,9,stay,45,199,0,244
3,6,A,double,30,128,15,173
3,6,A,hit,13,66,4,83
3,6,A,stay,10,204,0,214
3,7,10,double,170,369,60,599
3,7,10,hit,80,176,17,273
3,7,10,stay,192,727,0,919
3,7,2,double,57,80,12,149
3,7,2,hit,29,48,4,81
3,7,2,stay,68,151,0,219
3,7,3,double,58,68,5,131
3,7,3,hit,28,47,3,78
3,7,3,stay,82,140,0,222
3,7,4,double,58,83,9,150
3,7,4,hit,27,45,2,74
3,7,4,stay,82,162,0,244
3,7,5,double,65,99,5,169
3,7,5,hit,25,42,4,71
3,7,5,stay,94,143,0,237
3,7,6,double,51,91,8,150
3,7,6,hit,26,49,3,78
3,7,6,stay,85,144,0,229
3,7,7,double,49,69,3,121
3,7,7,hit,28,48,3,79
3,7,7,stay,54,133,0,187
3,7,8,double,51,83,9,143
3,7,8,hit,32,40,4,76
3,7,8,stay,54,164,0,218
3,7,9,double,47,86,13,146
3,7,9,hit,32,60,3,95
3,7,9,stay,44,166,0,210
3,7,A,double,32,121,14,167
3,7,A,hit,16,45,7,68
3,7,A,stay,9,220,0,229
3,8,10,double,259,293,62,614
3,8,10,hit,116,139,20,275
3,8,10,stay,176,753,0,929
3,8,2,double,67,70,5,142
3,8,2,hit,37,24,7,68
3,8,2,stay,76,147,0,223
3,8,3,double,60,72,7,139
3,8,3,hit,35,29,1,65
3,8,3,stay,77,122,0,199
3,8,4,double,67,65,15,147
3,8,4,hit,46,28,8,82
3,8,4,stay,88,161,0,249
3,8,5,double,86,64,6,156
3,8,5,hit,44,35,1,80
3,8,5,stay,82,144,0,226
3,8,6,double,100,51,6,157
3,8,6,hit,49,33,5,87
3,8,6,stay,90,149,0,239
3,8,7,double,80,71,4,155
3,8,7,hit,29,35,2,66
3,8,7,stay,73,194,0,267
3,8,8,double,59,68,10,137
3,8,8,hit,36,35,4,75
3,8,8,stay,49,167,0,216
3,8,9,double,76,60,6,142
3,8,9,hit,41,29,2,72
3,8,9,stay,61,194,0,255
3,8,A,double,40,92,19,151
3,8,A,hit,15,43,12,70
3,8,A,stay,14,219,0,233
3,9,10,double,153,500,23,676
3,9,10,hit,73,237,22,332
3,9,10,stay,192,677,0,869
3,9,2,double,30,119,5,154
3,9,2,hit,17,55,5,77
3,9,2,stay,69,161,0,230
3,9,3,double,29,108,5,142
3,9,3,hit,26,51,6,83
3,9,3,stay,85,153,0,238
3,9,4,double,39,100,6,145
3,9,4,hit,17,50,3,70
3,9,4,stay,95,154,0,249
3,9,5,double,41,95,4,140
3,9,5,hit,18,53,5,76
3,9,5,stay,80,148,0,228
3,9,6,double,41,110,4,155
3,9,6,hit,28,51,5,84
3,9,6,stay,78,147,0,225
3,9,7,double,57,112,9,178
3,9,7,hit,26,55,2,83
3,9,7,stay,63,167,0,230
3,9,8,double,33,123,2,158
3,9,8,hit,25,50,0,75
3,9,8,stay,56,181,0,237
3,9,9,double,38,104,10,152
3,9,9,hit,18,52,6,76
3,9,9,stay,48,154,0,202
3,9,A,double,22,120,12,154
3,9,A,hit,6,44,8,58
3,9,A,stay,14,211,0,225
3,A,10,double,200,360,38,598
3,A,10,hit,117,166,19,302
3,A,10,stay,217,689,0,906
3,A,2,double,61,77,9,147
3,A,2,hit,36,37,3,76
3,A,2,stay,71,147,0,218
3,A,3,double,76,68,9,153
3,A,3,hit,31,35,6,72
3,A,3,stay,77,147,0,224
3,A,4,double,80,61,13,154
3,A,4,hit,38,43,2,83
3,A,4,stay,98,150,0,248
3,A,5,double,83,70,6,159
3,A,5,hit,36,44,5,85
3,A,5,stay,75,163,0,238
3,A,6,double,63,76,9,148
3,A,6,hit,45,35,6,86
3,A,6,stay,83,158,0,241
3,A,7,double,62,85,9,156
3,A,7,hit,29,31,6,66
3,A,7,stay,52,153,0,205
3,A,8,double,59,86,7,152
3,A,8,hit,34,45,8,87
3,A,8,stay,56,173,0,229
3,A,9,double,50,73,11,134
3,A,9,hit,26,49,2,77
3,A,9,stay,64,169,0,233
3,A,A,double,24,124,16,164
3,A,A,hit,13,48,3,64
3,A,A,stay,14,224,0,238
4,10,10,double,405,1861,113,2379
4,10,10,hit,198,915,55,1168
4,10,10,stay,751,2842,0,3593
4,10,2,double,157,465,27,649
4,10,2,hit,84,265,17,366
4,10,2,stay,295,614,0,909
4,10,3,double,134,471,15,620
4,10,3,hit,57,255,18,330
4,10,3,stay,322,633,0,955
4,10,4,double,122,430,21,573
4,10,4,hit,75,210,4,289
4,10,4,stay,329,536,0,865
4,10,5,double,156,473,20,649
4,10,5,hit,64,237,12,313
4,10,5,stay,341,595,0,936
4,10,6,double,131,446,16,593
4,10,6,hit,79,214,6,299
4,10,6,stay,401,548,0,949
4,10,7,double,133,445,14,592
4,10,7,hit,68,256,13,337
4,10,7,stay,258,690,0,948
4,10,8,double,131,438,22,591
4,10,8,hit,70,223,10,303
4,10,8,stay,205,706,0,911
4,10,9,double,122,462,26,610
4,10,9,hit,57,246,13,316
4,10,9,stay,192,702,0,894
4,10,A,double,74,497,34,605
4,10,A,hit,31,273,20,324
4,10,A,stay,50,819,0,869
4,2,10,double,122,447,29,598
4,2,10,hit,60,224,3,287
4,2,10,stay,186,712,0,898
4,2,2,double,49,107,5,161
4,2,2,hit,27,43,3,73
4,2,2,stay,63,134,0,197
4,2,3,double,43,107,3,153
4,2,3,hit,20,45,2,67
4,2,3,stay,86,140,0,226
4,2,4,double,43,99,4,146
4,2,4,hit,26,63,4,93
4,2,4,stay,84,147,0,231
4,2,5,double,50,92,1,143
4,2,5,hit,31,46,3,80
4,2,5,stay,89,149,0,238
4,2,6,double,52,106,5,163
4,2,6,hit,33,52,1,86
4,2,6,stay,93,143,0,236
4,2,7,double,37,93,5,135
4,2,7,hit,22,53,4,79
4,2,7,stay,51,192,0,243
4,2,8,double,40,101,3,144
4,2,8,hit,21,52,3,76
4,2,8,stay,58,169,0,227
4,2,9,double,36,105,4,145
4,2,9,hit,11,45,1,57
4,2,9,stay,50,170,0,220
4,2,A,double,12,131,2,145
4,2,A,hit,13,58,8,79
4,2,A,stay,13,215,0,228
4,3,10,double,96,446,36,578
4,3,10,hit,54,246,15,315
4,3,10,stay,207,695,0,902
4,3,2,double,40,105,6,151
4,3,2,hit,29,51,4,84
4,3,2,stay,78,153,0,231
4,3,3,double,42,102,6,150
4,3,3,hit,17,44,5,66
4,3,3,stay,64,137,0,201
4,3,4,double,44,111,7,162
4,3,4,hit,23,45,6,74
4,3,4,stay,87,140,0,227
4,3,5,double,48,67,5,120
4,3,5,hit,25,56,7,88
4,3,5,stay,85,142,0,227
4,3,6,double,58,106,9,173
4,3,6,hit,22,56,4,82
4,3,6,stay,99,143,0,242
4,3,7,double,39,102,9,150
4,3,7,hit,25,42,6,73
4,3,7,stay,61,175,0,236
4,3,8,double,42,115,9,166
4,3,8,hit,22,47,6,75
4,3,8,stay,58,166,0,224
4,3,9,double,46,108,5,159
4,3,9,hit,15,61,2,78
4,3,9,stay,52,163,0,215
4,3,A,double,11,130,9,150
4,3,A,hit,8,73,5,86
4,3,A,stay,12,205,0,217
4,4,10,double,127,426,34,587
4,4,10,hit,79,209,13,301
4,4,10,stay,169,688,0,857
4,4,2,double,41,91,5,137
4,4,2,hit,17,47,4,68
4,4,2,stay,71,137,0,208
4,4,3,double,38,92,6,136
4,4,3,hit,27,41,2,70
4,4,3,stay,79,158,0,237
4,4,4,double,43,79,8,130
4,4,4,hit,24,46,5,75
4,4,4,stay,76,132,0,208
4,4,5,double,54,86,6,146
4,4,5,hit,26,36,3,65
4,4,5,stay,68,135,0,203
4,4,6,double,67,92,5,164
4,4,6,hit,29,33,4,66
4,4,6,stay,92,104,0,196
4,4,7,double,40,82,10,132
4,4,7,hit,25,34,5,64
4,4,7,stay,60,184,0,244
4,4,8,double,50,93,7,150
4,4,8,hit,18,46,11,75
4,4,8,stay,53,139,0,192
4,4,9,double,38,102,14,154
4,4,9,hit,21,56,2,79
4,4,9,stay,48,157,0,205
4,4,A,double,15,111,16,142
4,4,A,hit,9,60,6,75
4,4,A,stay,12,197,0,209
4,5,10,double,148,407,40,595
4,5,10,hit,81,203,19,303
4,5,10,stay,210,732,0,942
4,5,2,double,40,97,9,146
4,5,2,hit,28,43,3,74
4,5,2,stay,78,170,0,248
4,5,3,double,63,96,8,167
4,5,3,hit,30,51,1,82
4,5,3,stay,90,132,0,222
4,5,4,double,57,85,13,155
4,5,4,hit,26,55,1,82
4,5,4,stay,81,152,0,233
4,5,5,double,55,84,4,143
4,5,5,hit,33,45,2,80
4,5,5,stay,87,137,0,224
4,5,6,double,58,82,3,143
4,5,6,hit,30,43,2,75
4,5,6,stay,88,134,0,222
4,5,7,double,62,98,10,170
4,5,7,hit,34,40,8,82
4,5,7,stay,60,195,0,255
4,5,8,double,62,96,8,166
4,5,8,hit,24,43,1,68
4,5,8,stay,50,172,0,222
4,5,9,double,33,95,8,136
4,5,9,hit,16,47,7,70
4,5,9,stay,42,178,0,220
4,5,A,double,24,92,7,123
4,5,A,hit,12,67,9,88
4,5,A,stay,14,207,0,221
4,6,10,double,188,365,57,610
4,6,10,hit,104,208,33,345
4,6,10,stay,182,721,0,903
4,6,2,double,46,81,10,137
4,6,2,hit,32,48,6,86
4,6,2,stay,63,142,0,205
4,6,3,double,55,95,10,160
4,6,3,hit,33,48,4,85
4,6,3,stay,83,142,0,225
4,6,4,double,57,83,6,146
4,6,4,hit,27,41,1,69
4,6,4,stay,72,128,0,200
4,6,5,double,70,95,10,175
4,6,5,hit,31,41,5,77
4,6,5,stay,82,140,0,222
4,6,6,double,45,87,4,136
4,6,6,hit,31,37,5,73
4,6,6,stay,79,135,0,214
4,6,7,double,66,83,7,156
4,6,7,hit,22,59,0,81
4,6,7,stay,60,169,0,229
4,6,8,double,49,80,9,138
4,6,8,hit,29,51,4,84
4,6,8,stay,65,174,0,239
4,6,9,double,58,86,4,148
4,6,9,hit,33,47,3,83
4,6,9,stay,42,180,0,222
4,6,A,double,28,106,14,148
4,6,A,hit,17,60,6,83
4,6,A,stay,18,224,0,242
4,7,10,double,260,306,51,617
4,7,10,hit,136,129,17,282
4,7,10,stay,176,730,0,906
4,7,2,double,73,67,10,150
4,7,2,hit,27,38,5,70
4,7,2,stay,72,156,0,228
4,7,3,double,84,61,8,153
4,7,3,hit,37,29,8,74
4,7,3,stay,95,154,0,249
4,7,4,double,67,78,7,152
4,7,4,hit,34,28,6,68
4,7,4,stay,76,135,0,211
4,7,5,double,86,62,10,158
4,7,5,hit,38,43,6,87
4,7,5,stay,94,128,0,222
4,7,6,double,77,63,8,148
4,7,6,hit,33,29,2,64
4,7,6,stay,100,133,0,233
4,7,7,double,71,65,14,150
4,7,7,hit,41,33,1,75
4,7,7,stay,55,145,0,200
4,7,8,double,60,63,9,132
4,7,8,hit,30,36,1,67
4,7,8,stay,43,163,0,206
4,7,9,double,57,83,9,149
4,7,9,hit,47,38,8,93
4,7,9,stay,60,197,0,257
4,7,A,double,47,97,28,172
4,7,A,hit,32,42,5,79
4,7,A,stay,14,192,0,206
4,8,10,double,139,465,30,634
4,8,10,hit,72,227,16,315
4,8,10,stay,174,692,0,866
4,8,2,double,43,106,6,155
4,8,2,hit,19,71,4,94
4,8,2,stay,71,152,0,223
4,8,3,double,28,118,8,154
4,8,3,hit,22,49,3,74
4,8,3,stay,75,157,0,232
4,8,4,double,42,107,4,153
4,8,4,hit,22,47,3,72
4,8,4,stay,87,141,0,228
4,8,5,double,46,118,2,166
4,8,5,hit,19,60,2,81
4,8,5,stay,106,144,0,250
4,8,6,double,31,114,6,151
4,8,6,hit,15,68,0,83
4,8,6,stay,96,155,0,251
4,8,7,double,43,107,3,153
4,8,7,hit,17,56,3,76
4,8,7,stay,57,182,0,239
4,8,8,double,37,107,6,150
4,8,8,hit,20,55,3,78
4,8,8,stay,40,180,0,220
4,8,9,double,32,115,9,156
4,8,9,hit,19,33,2,54
4,8,9,stay,57,180,0,237
4,8,A,double,19,107,7,133
4,8,A,hit,6,40,5,51
4,8,A,stay,20,225,0,245
4,9,10,double,121,494,26,641
4,9,10,hit,62,246,10,318
4,9,10,stay,180,779,0,959
4,9,2,double,39,112,10,161
4,9,2,hit,20,51,1,72
4,9,2,stay,80,139,0,219
4,9,3,double,22,102,2,126
4,9,3,hit,19,68,2,89
4,9,3,stay,85,158,0,243
4,9,4,double,32,101,8,141
4,9,4,hit,9,45,4,58
4,9,4,stay,76,143,0,219
4,9,5,double,33,122,10,165
4,9,5,hit,17,57,3,77
4,9,5,stay,82,151,0,233
4,9,6,double,42,113,6,161
4,9,6,hit,16,49,4,69
4,9,6,stay,91,134,0,225
4,9,7,double,41,117,6,164
4,9,7,hit,21,60,3,84
4,9,7,stay,52,157,0,209
4,9,8,double,28,109,11,148
4,9,8,hit,17,58,2,77
4,9,8,stay,54,155,0,209
4,9,9,double,32,97,6,135
4,9,9,hit,17,52,2,71
4,9,9,stay,45,184,0,229
4,9,A,double,22,137,11,170
4,9,A,hit,17,90,7,114
4,9,A,stay,16,203,0,219
4,A,10,double,212,386,45,643
4,A,10,hit,97,186,15,298
4,A,10,stay,187,717,0,904
4,A,2,double,81,64,8,153
4,A,2,hit,35,35,3,73
4,A,2,stay,77,171,0,248
4,A,3,double,91,78,7,176
4,A,3,hit,44,34,5,83
4,A,3,stay,80,146,0,226
4,A,4,double,70,78,5,153
4,A,4,hit,39,32,4,75
4,A,4,stay,79,125,0,204
4,A,5,double,70,70,10,150
4,A,5,hit,40,42,5,87
4,A,5,stay,97,130,0,227
4,A,6,double,77,66,5,148
4,A,6,hit,50,35,3,88
4,A,6,stay,84,126,0,210
4,A,7,double,62,85,4,151
4,A,7,hit,42,51,5,98
4,A,7,stay,54,192,0,246
4,A,8,double,69,87,11,167
4,A,8,hit,27,41,2,70
4,A,8,stay,49,187,0,236
4,A,9,double,90,105,5,200
4,A,9,hit,19,49,4,72
4,A,9,stay,43,173,0,216
4,A,A,double,33,80,17,130
4,A,A,hit,13,52,5,70
4,A,A,stay,13,172,0,185
5,10,10,double,367,1937,103,2407
5,10,10,hit,194,959,51,1204
5,10,10,stay,707,2940,0,3647
5,10,2,double,134,448,19,601
5,10,2,hit,52,244,10,306
5,10,2,stay,270,618,0,888
5,10,3,double,129,498,25,652
5,10,3,hit,59,229,10,298
5,10,3,stay,318,602,0,920
5,10,4,double,122,475,15,612
5,10,4,hit,59,254,6,319
5,10,4,stay,385,619,0,1004
5,10,5,double,120,460,22,602
5,10,5,hit,72,243,5,320
5,10,5,stay,356,527,0,883
5,10,6,double,140,468,19,627
5,10,6,hit,46,228,11,285
5,10,6,stay,406,557,0,963
5,10,7,double,131,490,25,646
5,10,7,hit,61,230,20,311
5,10,7,stay,250,695,0,945
5,10,8,double,120,467,15,602
5,10,8,hit,73,229,11,313
5,10,8,stay,230,653,0,883
5,10,9,double,129,493,24,646
5,10,9,hit,62,246,17,325
5,10,9,stay,214,723,0,937
5,10,A,double,62,488,31,581
5,10,A,hit,40,285,19,344
5,10,A,stay,47,830,0,877
5,2,10,double,133,454,32,619
5,2,10,hit,60,231,16,307
5,2,10,stay,187,722,0,909
5,2,2,double,55,84,6,145
5,2,2,hit,26,43,4,73
5,2,2,stay,62,125,0,187
5,2,3,double,48,96,5,149
5,2,3,hit,21,41,1,63
5,2,3,stay,80,145,0,225
5,2,4,double,49,96,5,150
5,2,4,hit,26,40,1,67
5,2,4,stay,58,164,0,222
5,2,5,double,57,79,10,146
5,2,5,hit,26,51,7,84
5,2,5,stay,81,131,0,212
5,2,6,double,45,79,9,133
5,2,6,hit,20,40,6,66
5,2,6,stay,99,150,0,249
5,2,7,double,49,94,11,154
5,2,7,hit,22,59,8,89
5,2,7,stay,49,180,0,229
5,2,8,double,32,100,7,139
5,2,8,hit,16,50,7,73
5,2,8,stay,44,183,0,227
5,2,9,double,45,92,5,142
5,2,9,hit,23,60,7,90
5,2,9,stay,46,196,0,242
5,2,A,double,15,140,6,161
5,2,A,hit,4,85,2,91
5,2,A,stay,13,220,0,233
5,3,10,double,140,429,26,595
5,3,10,hit,62,188,15,265
5,3,10,stay,193,738,0,931
5,3,2,double,50,89,9,148
5,3,2,hit,28,46,5,79
5,3,2,stay,65,143,0,208
5,3,3,double,43,93,10,146
5,3,3,hit,28,45,4,77
5,3,3,stay,80,120,0,200
5,3,4,double,47,87,4,138
5,3,4,hit,26,45,7,78
5,3,4,stay,75,137,0,212
5,3,5,double,60,80,2,142
5,3,5,hit,33,32,2,67
5,3,5,stay,93,136,0,229
5,3,6,double,61,91,5,157
5,3,6,hit,38,43,3,84
5,3,6,stay,93,158,0,251
5,3,7,double,51,105,9,165
5,3,7,hit,18,45,10,73
5,3,7,stay,52,163,0,215
5,3,8,double,50,100,15,165
5,3,8,hit,21,46,8,75
5,3,8,stay,50,172,0,222
5,3,9,double,50,110,11,171
5,3,9,hit,21,41,3,65
5,3,9,stay,41,175,0,216
5,3,A,double,17,114,9,140
5,3,A,hit,10,61,4,75
5,3,A,stay,15,213,0,228
5,4,10,double,154,419,40,613
5,4,10,hit,77,196,28,301
5,4,10,stay,217,685,0,902
5,4,2,double,46,83,7,136
5,4,2,hit,31,62,7,100
5,4,2,stay,66,136,0,202
5,4,3,double,46,87,11,144
5,4,3,hit,28,33,6,67
5,4,3,stay,63,152,0,215
5,4,4,double,45,82,5,132
5,4,4,hit,20,43,2,65
5,4,4,stay,84,150,0,234
5,4,5,double,55,88,7,150
5,4,5,hit,24,32,3,59
5,4,5,stay,83,146,0,229
5,4,6,double,64,101,5,170
5,4,6,hit,36,47,5,88
5,4,6,stay,93,144,0,237
5,4,7,double,49,70,7,126
5,4,7,hit,31,45,2,78
5,4,7,stay,65,209,0,274
5,4,8,double,32,94,11,137
5,4,8,hit,16,48,5,69
5,4,8,stay,53,158,0,211
5,4,9,double,39,88,16,143
5,4,9,hit,22,57,11,90
5,4,9,stay,43,167,0,210
5,4,A,double,28,127,15,170
5,4,A,hit,8,61,5,74
5,4,A,stay,12,254,0,266
5,5,10,double,157,359,59,575
5,5,10,hit,80,186,20,286
5,5,10,stay,182,635,0,817
5,5,2,double,46,87,8,141
5,5,2,hit,20,44,8,72
5,5,2,stay,60,138,0,198
5,5,3,double,53,85,11,149
5,5,3,hit,37,34,3,74
5,5,3,stay,89,147,0,236
5,5,4,double,47,81,11,139
5,5,4,hit,31,42,0,73
5,5,4,stay,74,160,0,234
5,5,5,double,48,71,4,123
5,5,5,hit,22,37,6,65
5,5,5,stay,91,103,0,194
5,5,6,double,53,82,7,142
5,5,6,hit,27,36,5,68
5,5,6,stay,79,120,0,199
5,5,7,double,49,75,7,131
5,5,7,hit,30,48,4,82
5,5,7,stay,53,164,0,217
5,5,8,double,50,79,1,130
5,5,8,hit,33,36,4,73
5,5,8,stay,35,184,0,219
5,5,9,double,47,92,13,152
5,5,9,hit,22,49,4,75
5,5,9,stay,47,179,0,226
5,5,A,double,21,89,10,120
5,5,A,hit,23,50,8,81
5,5,A,stay,10,238,0,248
5,6,10,double,309,271,43,623
5,6,10,hit,117,143,31,291
5,6,10,stay,173,732,0,905
5,6,2,double,74,68,10,152
5,6,2,hit,38,40,4,82
5,6,2,stay,79,171,0,250
5,6,3,double,81,86,9,176
5,6,3,hit,37,35,6,78
5,6,3,stay,73,157,0,230
5,6,4,double,64,73,13,150
5,6,4,hit,38,49,4,91
5,6,4,stay,96,148,0,244
5,6,5,double,76,65,7,148
5,6,5,hit,36,32,4,72
5,6,5,stay,93,153,0,246
5,6,6,double,81,63,11,155
5,6,6,hit,35,23,4,62
5,6,6,stay,92,127,0,219
5,6,7,double,88,63,10,161
5,6,7,hit,27,39,1,67
5,6,7,stay,69,195,0,264
5,6,8,double,78,72,13,163
5,6,8,hit,31,29,1,61
5,6,8,stay,59,176,0,235
5,6,9,double,69,77,12,158
5,6,9,hit,28,40,5,73
5,6,9,stay,46,197,0,243
5,6,A,double,41,116,28,185
5,6,A,hit,20,36,12,68
5,6,A,stay,9,243,0,252
5,7,10,double,118,452,27,597
5,7,10,hit,56,229,10,295
5,7,10,stay,171,702,0,873
5,7,2,double,36,122,7,165
5,7,2,hit,30,54,3,87
5,7,2,stay,65,166,0,231
5,7,3,double,37,107,10,154
5,7,3,hit,19,49,7,75
5,7,3,stay,79,142,0,221
5,7,4,double,39,117,4,160
5,7,4,hit,20,49,2,71
5,7,4,stay,90,128,0,218
5,7,5,double,50,105,2,157
5,7,5,hit,15,41,6,62
5,7,5,stay,99,123,0,222
5,7,6,double,41,119,4,164
5,7,6,hit,23,65,7,95
5,7,6,stay,103,120,0,223
5,7,7,double,32,86,8,126
5,7,7,hit,15,52,3,70
5,7,7,stay,62,152,0,214
5,7,8,double,30,93,6,129
5,7,8,hit,17,47,4,68
5,7,8,stay,49,165,0,214
5,7,9,double,28,121,7,156
5,7,9,hit,19,49,2,70
5,7,9,stay,53,168,0,221
5,7,A,double,17,127,15,159
5,7,A,hit,6,60,5,71
5,7,A,stay,13,205,0,218
5,8,10,double,138,483,33,654
5,8,10,hit,50,253,9,312
5,8,10,stay,182,727,0,909
5,8,2,double,33,115,5,153
5,8,2,hit,17,48,1,66
5,8,2,stay,78,157,0,235
5,8,3,double,40,104,8,152
5,8,3,hit,16,42,2,60
5,8,3,stay,80,140,0,220
5,8,4,double,39,117,2,158
5,8,4,hit,19,53,3,75
5,8,4,stay,92,144,0,236
5,8,5,double,32,122,2,156
5,8,5,hit,13,55,3,71
5,8,5,stay,87,125,0,212
5,8,6,double,32,145,3,180
5,8,6,hit,12,58,4,74
5,8,6,stay,100,105,0,205
5,8,7,double,34,101,12,147
5,8,7,hit,17,72,4,93
5,8,7,stay,52,177,0,229
5,8,8,double,29,119,3,151
5,8,8,hit,13,57,1,71
5,8,8,stay,33,153,0,186
5,8,9,double,29,113,6,148
5,8,9,hit,25,69,6,100
5,8,9,stay,58,177,0,235
5,8,A,double,16,121,13,150
5,8,A,hit,5,59,8,72
5,8,A,stay,13,210,0,223
5,9,10,double,109,519,22,650
5,9,10,hit,53,230,18,301
5,9,10,stay,192,768,0,960
5,9,2,double,38,104,8,150
5,9,2,hit,19,50,1,70
5,9,2,stay,72,154,0,226
5,9,3,double,36,125,5,166
5,9,3,hit,18,65,3,86
5,9,3,stay,67,149,0,216
5,9,4,double,37,116,7,160
5,9,4,hit,12,54,1,67
5,9,4,stay,89,130,0,219
5,9,5,double,36,123,8,167
5,9,5,hit,21,56,4,81
5,9,5,stay,92,135,0,227
5,9,6,double,39,125,2,166
5,9,6,hit,19,47,4,70
5,9,6,stay,84,136,0,220
5,9,7,double,43,120,5,168
5,9,7,hit,9,56,3,68
5,9,7,stay,47,162,0,209
5,9,8,double,34,121,3,158
5,9,8,hit,14,47,3,64
5,9,8,stay,54,171,0,225
5,9,9,double,33,103,6,142
5,9,9,hit,18,57,3,78
5,9,9,stay,62,176,0,238
5,9,A,double,20,144,4,168
5,9,A,hit,12,65,3,80
5,9,A,stay,11,211,0,222
5,A,10,double,155,356,51,562
5,A,10,hit,119,203,17,339
5,A,10,stay,208,703,0,911
5,A,2,double,70,76,7,153
5,A,2,hit,37,43,4,84
5,A,2,stay,75,160,0,235
5,A,3,double,64,76,6,146
5,A,3,hit,27,29,7,63
5,A,3,stay,76,153,0,229
5,A,4,double,64,76,11,151
5,A,4,hit,33,31,3,67
5,A,4,stay,78,157,0,235
5,A,5,double,83,72,9,164
5,A,5,hit,30,33,3,66
5,A,5,stay,78,140,0,218
5,A,6,double,84,71,8,163
5,A,6,hit,36,33,3,72
5,A,6,stay,96,153,0,249
5,A,7,double,74,79,10,163
5,A,7,hit,23,37,2,62
5,A,7,stay,56,150,0,206
5,A,8,double,78,68,10,156
5,A,8,hit,29,44,5,78
5,A,8,stay,56,179,0,235
5,A,9,double,60,98,13,171
5,A,9,hit,22,46,1,69
5,A,9,stay,52,195,0,247
5,A,A,double,26,108,14,148
5,A,A,hit,12,50,11,73
5,A,A,stay,13,196,0,209
6,10,10,double,352,1879,90,2321
6,10,10,hit,189,925,57,1171
6,10,10,stay,726,2869,0,3595
6,10,2,double,104,483,30,617
6,10,2,hit,69,235,6,310
6,10,2,stay,315,600,0,915
6,10,3,double,103,468,32,603
6,10,3,hit,47,240,3,290
6,10,3,stay,325,548,0,873
6,10,4,double,122,510,17,649
6,10,4,hit,51,226,10,287
6,10,4,stay,322,606,0,928
6,10,5,double,89,524,25,638
6,10,5,hit,59,239,3,301
6,10,5,stay,366,536,0,902
6,10,6,double,98,441,20,559
6,10,6,hit,52,234,9,295
6,10,6,stay,348,503,0,851
6,10,7,double,141,466,18,625
6,10,7,hit,72,238,17,327
6,10,7,stay,244,689,0,933
6,10,8,double,112,428,22,562
6,10,8,hit,49,225,15,289
6,10,8,stay,203,676,0,879
6,10,9,double,113,506,21,640
6,10,9,hit,44,227,8,279
6,10,9,stay,214,716,0,930
6,10,A,double,55,523,54,632
6,10,A,hit,37,225,11,273
6,10,A,stay,58,843,0,901
6,2,10,double,145,434,24,603
6,2,10,hit,59,216,14,289
6,2,10,stay,204,745,0,949
6,2,2,double,40,97,7,144
6,2,2,hit,19,49,6,74
6,2,2,stay,62,134,0,196
6,2,3,double,44,82,7,133
6,2,3,hit,28,54,5,87
6,2,3,stay,79,145,0,224
6,2,4,double,46,95,6,147
6,2,4,hit,25,46,6,77
6,2,4,stay,79,157,0,236
6,2,5,double,59,113,3,175
6,2,5,hit,25,32,1,58
6,2,5,stay,101,146,0,247
6,2,6,double,45,78,7,130
6,2,6,hit,31,43,2,76
6,2,6,stay,92,122,0,214
6,2,7,double,60,101,8,169
6,2,7,hit,31,58,6,95
6,2,7,stay,51,176,0,227
6,2,8,double,44,101,12,157
6,2,8,hit,28,45,5,78
6,2,8,stay,48,156,0,204
6,2,9,double,34,107,8,149
6,2,9,hit,18,49,3,70
6,2,9,stay,41,200,0,241
6,2,A,double,22,126,9,157
6,2,A,hit,7,46,6,59
6,2,A,stay,16,207,0,223
6,3,10,double,164,444,38,646
6,3,10,hit,73,231,26,330
6,3,10,stay,201,705,0,906
6,3,2,double,43,87,6,136
6,3,2,hit,22,34,7,63
6,3,2,stay,67,177,0,244
6,3,3,double,41,86,6,133
6,3,3,hit,27,38,0,65
6,3,3,stay,71,160,0,231
6,3,4,double,63,97,8,168
6,3,4,hit,26,40,1,67
6,3,4,stay,84,150,0,234
6,3,5,double,58,87,7,152
6,3,5,hit,29,31,3,63
6,3,5,stay,72,144,0,216
6,3,6,double,54,89,5,148
6,3,6,hit,22,37,0,59
6,3,6,stay,83,125,0,208
6,3,7,double,60,103,8,171
6,3,7,hit,32,43,4,79
6,3,7,stay,78,155,0,233
6,3,8,double,53,94,10,157
6,3,8,hit,35,48,3,86
6,3,8,stay,50,174,0,224
6,3,9,double,44,103,9,156
6,3,9,hit,31,47,9,87
6,3,9,stay,41,184,0,225
6,3,A,double,24,101,14,139
6,3,A,hit,10,62,2,74
6,3,A,stay,9,209,0,218
6,4,10,double,151,389,59,599
6,4,10,hit,88,211,28,327
6,4,10,stay,181,742,0,923
6,4,2,double,56,85,12,153
6,4,2,hit,31,53,5,89
6,4,2,stay,79,142,0,221
6,4,3,double,77,86,6,169
6,4,3,hit,24,34,4,62
6,4,3,stay,87,136,0,223
6,4,4,double,47,80,8,135
6,4,4,hit,34,40,5,79
6,4,4,stay,74,102,0,176
6,4,5,double,61,76,4,141
6,4,5,hit,33,39,1,73
6,4,5,stay,75,156,0,231
6,4,6,double,71,76,6,153
6,4,6,hit,37,54,2,93
6,4,6,stay,78,126,0,204
6,4,7,double,55,80,9,144
6,4,7,hit,29,37,4,70
6,4,7,stay,61,179,0,240
6,4,8,double,49,84,5,138
6,4,8,hit,19,42,3,64
6,4,8,stay,63,173,0,236
6,4,9,double,46,69,11,126
6,4,9,hit,30,50,3,83
6,4,9,stay,49,178,0,227
6,4,A,double,30,115,17,162
6,4,A,hit,15,54,12,81
6,4,A,stay,20,196,0,216
6,5,10,double,226,298,59,583
6,5,10,hit,134,149,26,309
6,5,10,stay,170,742,0,912
6,5,2,double,82,74,13,169
6,5,2,hit,32,46,7,85
6,5,2,stay,79,156,0,235
6,5,3,double,74,86,16,176
6,5,3,hit,39,33,5,77
6,5,3,stay,88,162,0,250
6,5,4,double,83,71,4,158
6,5,4,hit,47,31,4,82
6,5,4,stay,94,134,0,228
6,5,5,double,76,56,11,143
6,5,5,hit,42,26,4,72
6,5,5,stay,81,108,0,189
6,5,6,double,69,70,8,147
6,5,6,hit,49,38,9,96
6,5,6,stay,82,126,0,208
6,5,7,double,80,55,7,142
6,5,7,hit,45,44,5,94
6,5,7,stay,63,156,0,219
6,5,8,double,76,76,10,162
6,5,8,hit,31,43,2,76
6,5,8,stay,53,172,0,225
6,5,9,double,77,81,13,171
6,5,9,hit,38,40,7,85
6,5,9,stay,40,186,0,226
6,5,A,double,48,87,31,166
6,5,A,hit,22,39,6,67
6,5,A,stay,4,220,0,224
6,6,10,double,130,437,21,588
6,6,10,hit,53,210,11,274
6,6,10,stay,167,674,0,841
6,6,2,double,53,106,7,166
6,6,2,hit,21,49,6,76
6,6,2,stay,67,142,0,209
6,6,3,double,34,105,3,142
6,6,3,hit,21,69,4,94
6,6,3,stay,71,160,0,231
6,6,4,double,40,83,5,128
6,6,4,hit,18,44,2,64
6,6,4,stay,88,135,0,223
6,6,5,double,48,84,5,137
6,6,5,hit,23,48,5,76
6,6,5,stay,86,138,0,224
6,6,6,double,47,70,1,118
6,6,6,hit,21,48,3,72
6,6,6,stay,86,100,0,186
6,6,7,double,36,88,5,129
6,6,7,hit,20,60,4,84
6,6,7,stay,55,155,0,210
6,6,8,double,32,98,7,137
6,6,8,hit,18,53,4,75
6,6,8,stay,56,171,0,227
6,6,9,double,40,109,3,152
6,6,9,hit,23,57,1,81
6,6,9,stay,67,175,0,242
6,6,A,double,11,110,10,131
6,6,A,hit,8,60,4,72
6,6,A,stay,16,215,0,231
6,7,10,double,120,488,26,634
6,7,10,hit,67,255,12,334
6,7,10,stay,205,735,0,940
6,7,2,double,35,109,8,152
6,7,2,hit,25,62,3,90
6,7,2,stay,77,162,0,239
6,7,3,double,31,90,10,131
6,7,3,hit,16,59,3,78
6,7,3,stay,72,152,0,224
6,7,4,double,41,129,1,171
6,7,4,hit,15,49,3,67
6,7,4,stay,96,130,0,226
6,7,5,double,53,102,5,160
6,7,5,hit,26,66,2,94
6,7,5,stay,84,163,0,247
6,7,6,double,42,96,8,146
6,7,6,hit,22,48,1,71
6,7,6,stay,81,150,0,231
6,7,7,double,31,139,10,180
6,7,7,hit,24,46,2,72
6,7,7,stay,74,169,0,243
6,7,8,double,36,116,5,157
6,7,8,hit,18,62,6,86
6,7,8,stay,46,173,0,219
6,7,9,double,20,125,9,154
6,7,9,hit,19,74,4,97
6,7,9,stay,53,164,0,217
6,7,A,double,22,135,10,167
6,7,A,hit,6,60,2,68
6,7,A,stay,12,239,0,251
6,8,10,double,113,467,29,609
6,8,10,hit,45,238,7,290
6,8,10,stay,186,747,0,933
6,8,2,double,33,123,6,162
6,8,2,hit,17,53,1,71
6,8,2,stay,73,126,0,199
6,8,3,double,42,100,6,148
6,8,3,hit,10,60,1,71
6,8,3,stay,73,154,0,227
6,8,4,double,29,110,8,147
6,8,4,hit,16,59,4,79
6,8,4,stay,97,148,0,245
6,8,5,double,30,100,5,135
6,8,5,hit,15,67,5,87
6,8,5,stay,97,134,0,231
6,8,6,double,36,104,3,143
6,8,6,hit,14,47,3,64
6,8,6,stay,82,139,0,221
6,8,7,double,33,111,5,149
6,8,7,hit,19,56,4,79
6,8,7,stay,60,191,0,251
6,8,8,double,35,107,5,147
6,8,8,hit,14,59,3,76
6,8,8,stay,40,161,0,201
6,8,9,double,38,116,8,162
6,8,9,hit,23,49,2,74
6,8,9,stay,46,190,0,236
6,8,A,double,16,128,8,152
6,8,A,hit,10,63,8,81
6,8,A,stay,9,221,0,230
6,9,10,double,87,516,26,629
6,9,10,hit,43,243,16,302
6,9,10,stay,182,723,0,905
6,9,2,double,33,139,5,177
6,9,2,hit,15,69,2,86
6,9,2,stay,68,143,0,211
6,9,3,double,27,124,4,155
6,9,3,hit,14,61,5,80
6,9,3,stay,58,148,0,206
6,9,4,double,21,131,7,159
6,9,4,hit,15,56,2,73
6,9,4,stay,87,158,0,245
6,9,5,double,31,120,5,156
6,9,5,hit,14,70,3,87
6,9,5,stay,81,135,0,216
6,9,6,double,39,100,2,141
6,9,6,hit,19,66,2,87
6,9,6,stay,105,124,0,229
6,9,7,double,37,127,7,171
6,9,7,hit,10,50,3,63
6,9,7,stay,60,170,0,230
6,9,8,double,34,108,10,152
6,9,8,hit,12,67,4,83
6,9,8,stay,56,167,0,223
6,9,9,double,30,113,5,148
6,9,9,hit,11,68,2,81
6,9,9,stay,48,197,0,245
6,9,A,double,24,120,9,153
6,9,A,hit,5,63,6,74
6,9,A,stay,17,209,0,226
6,A,10,double,216,363,60,639
6,A,10,hit,107,194,24,325
6,A,10,stay,180,645,99,924
6,A,2,double,68,74,9,151
6,A,2,hit,29,49,7,85
6,A,2,stay,77,118,45,240
6,A,3,double,62,62,15,139
6,A,3,hit,27,25,4,56
6,A,3,stay,91,100,27,218
6,A,4,double,63,72,9,144
6,A,4,hit,45,39,2,86
6,A,4,stay,96,103,31,230
6,A,5,double,74,62,13,149
6,A,5,hit,40,30,9,79
6,A,5,stay,93,104,28,225
6,A,6,double,63,65,16,144
6,A,6,hit,30,25,5,60
6,A,6,stay,84,94,35,213
6,A,7,double,70,85,18,173
6,A,7,hit,36,28,9,73
6,A,7,stay,68,85,104,257
6,A,8,double,66,87,8,161
6,A,8,hit,26,46,6,78
6,A,8,stay,50,127,26,203
6,A,9,double,58,72,15,145
6,A,9,hit,24,47,5,76
6,A,9,stay,48,131,34,213
6,A,A,double,24,98,10,132
6,A,A,hit,16,46,3,65
6,A,A,stay,13,182,33,228
7,10,10,double,353,2042,91,2486
7,10,10,hit,153,1031,36,1220
7,10,10,stay,727,2528,392,3647
7,10,2,double,82,511,18,611
7,10,2,hit,44,268,13,325
7,10,2,stay,297,499,148,944
7,10,3,double,86,508,15,609
7,10,3,hit,52,231,7,290
7,10,3,stay,328,501,108,937
7,10,4,double,93,482,11,586
7,10,4,hit,51,253,6,310
7,10,4,stay,331,442,115,888
7,10,5,double,109,521,18,648
7,10,5,hit,46,241,10,297
7,10,5,stay,370,502,110,982
7,10,6,double,100,500,19,619
7,10,6,hit,56,234,8,298
7,10,6,stay,380,398,146,924
7,10,7,double,105,456,13,574
7,10,7,hit,54,283,8,345
7,10,7,stay,208,311,322,841
7,10,8,double,108,462,11,581
7,10,8,hit,56,227,8,291
7,10,8,stay,201,634,103,938
7,10,9,double,95,465,21,581
7,10,9,hit,51,267,12,330
7,10,9,stay,200,586,118,904
7,10,A,double,57,509,26,592
7,10,A,hit,29,281,13,323
7,10,A,stay,48,764,139,951
7,2,10,double,144,421,43,608
7,2,10,hit,79,208,15,302
7,2,10,stay,169,688,0,857
7,2,2,double,31,92,7,130
7,2,2,hit,21,42,3,66
7,2,2,stay,62,148,0,210
7,2,3,double,50,82,6,138
7,2,3,hit,26,46,1,73
7,2,3,stay,80,123,0,203
7,2,4,double,46,76,11,133
7,2,4,hit,27,36,3,66
7,2,4,stay,87,167,0,254
7,2,5,double,64,111,8,183
7,2,5,hit,39,36,2,77
7,2,5,stay,108,133,0,241
7,2,6,double,61,100,9,170
7,2,6,hit,23,34,4,61
7,2,6,stay,110,124,0,234
7,2,7,double,58,90,5,153
7,2,7,hit,33,51,4,88
7,2,7,stay,50,162,0,212
7,2,8,double,54,110,9,173
7,2,8,hit,25,51,3,79
7,2,8,stay,43,187,0,230
7,2,9,double,37,104,17,158
7,2,9,hit,37,47,5,89
7,2,9,stay,72,196,0,268
7,2,A,double,29,128,13,170
7,2,A,hit,10,64,6,80
7,2,A,stay,14,216,0,230
7,3,10,double,179,389,49,617
7,3,10,hit,89,219,20,328
7,3,10,stay,189,763,0,952
7,3,2,double,54,80,9,143
7,3,2,hit,29,43,8,80
7,3,2,stay,59,154,0,213
7,3,3,double,59,82,8,149
7,3,3,hit,17,38,5,60
7,3,3,stay,68,152,0,220
7,3,4,double,56,89,7,152
7,3,4,hit,38,39,2,79
7,3,4,stay,82,152,0,234
7,3,5,double,69,84,4,157
7,3,5,hit,32,30,6,68
7,3,5,stay,89,149,0,238
7,3,6,double,59,77,9,145
7,3,6,hit,34,41,6,81
7,3,6,stay,99,154,0,253
7,3,7,double,65,71,5,141
7,3,7,hit,37,32,3,72
7,3,7,stay,47,170,0,217
7,3,8,double,53,96,9,158
7,3,8,hit,36,31,3,70
7,3,8,stay,38,165,0,203
7,3,9,double,46,97,7,150
7,3,9,hit,24,51,1,76
7,3,9,stay,52,175,0,227
7,3,A,double,26,95,19,140
7,3,A,hit,16,63,7,86
7,3,A,stay,10,230,0,240
7,4,10,double,241,290,51,582
7,4,10,hit,135,156,33,324
7,4,10,stay,209,703,0,912
7,4,2,double,85,68,9,162
7,4,2,hit,40,42,9,91
7,4,2,stay,73,175,0,248
7,4,3,double,78,59,6,143
7,4,3,hit,35,36,2,73
7,4,3,stay,94,151,0,245
7,4,4,double,91,82,7,180
7,4,4,hit,36,34,3,73
7,4,4,stay,83,151,0,234
7,4,5,double,72,53,6,131
7,4,5,hit,31,36,4,71
7,4,5,stay,95,140,0,235
7,4,6,double,97,65,6,168
7,4,6,hit,42,30,4,76
7,4,6,stay,99,132,0,231
7,4,7,double,75,73,7,155
7,4,7,hit,39,33,8,80
7,4,7,stay,56,166,0,222
7,4,8,double,77,72,12,161
7,4,8,hit,41,40,3,84
7,4,8,stay,43,179,0,222
7,4,9,double,62,78,13,153
7,4,9,hit,37,38,5,80
7,4,9,stay,66,202,0,268
7,4,A,double,34,90,22,146
7,4,A,hit,24,41,14,79
7,4,A,stay,14,227,0,241
7,5,10,double,129,450,29,608
7,5,10,hit,57,220,11,288
7,5,10,stay,185,721,0,906
7,5,2,double,32,97,6,135
7,5,2,hit,14,52,3,69
7,5,2,stay,79,172,0,251
7,5,3,double,51,107,7,165
7,5,3,hit,19,47,7,73
7,5,3,stay,90,162,0,252
7,5,4,double,41,106,2,149
7,5,4,hit,23,36,5,64
7,5,4,stay,79,151,0,230
7,5,5,double,39,108,4,151
7,5,5,hit,27,49,2,78
7,5,5,stay,82,119,0,201
7,5,6,double,41,86,3,130
7,5,6,hit,22,55,2,79
7,5,6,stay,95,129,0,224
7,5,7,double,39,104,8,151
7,5,7,hit,18,55,2,75
7,5,7,stay,49,168,0,217
7,5,8,double,39,87,6,132
7,5,8,hit,13,54,4,71
7,5,8,stay,46,182,0,228
7,5,9,double,39,112,2,153
7,5,9,hit,13,49,4,66
7,5,9,stay,55,201,0,256
7,5,A,double,16,114,2,132
7,5,A,hit,11,67,2,80
7,5,A,stay,15,223,0,238
7,6,10,double,121,482,25,628
7,6,10,hit,61,208,16,285
7,6,10,stay,183,714,0,897
7,6,2,double,36,125,5,166
7,6,2,hit,9,57,1,67
7,6,2,stay,72,145,0,217
7,6,3,double,41,106,4,151
7,6,3,hit,19,41,2,62
7,6,3,stay,92,153,0,245
7,6,4,double,45,113,9,167
7,6,4,hit,16,55,2,73
7,6,4,stay,100,146,0,246
7,6,5,double,36,118,7,161
7,6,5,hit,21,55,2,78
7,6,5,stay,87,132,0,219
7,6,6,double,38,91,6,135
7,6,6,hit,24,43,4,71
7,6,6,stay,100,141,0,241
7,6,7,double,33,99,6,138
7,6,7,hit,12,53,3,68
7,6,7,stay,66,157,0,223
7,6,8,double,36,101,5,142
7,6,8,hit,16,57,3,76
7,6,8,stay,54,163,0,217
7,6,9,double,30,106,5,141
7,6,9,hit,14,66,3,83
7,6,9,stay,48,188,0,236
7,6,A,double,10,104,9,123
7,6,A,hit,11,68,5,84
7,6,A,stay,11,223,0,234
7,7,10,double,103,471,23,597
7,7,10,hit,41,232,15,288
7,7,10,stay,184,686,0,870
7,7,2,double,31,89,5,125
7,7,2,hit,13,59,0,72
7,7,2,stay,76,133,0,209
7,7,3,double,27,105,5,137
7,7,3,hit,19,61,1,81
7,7,3,stay,57,136,0,193
7,7,4,double,37,102,9,148
7,7,4,hit,23,49,7,79
7,7,4,stay,88,154,0,242
7,7,5,double,31,109,1,141
7,7,5,hit,19,61,2,82
7,7,5,stay,80,144,0,224
7,7,6,double,34,108,0,142
7,7,6,hit,25,48,5,78
7,7,6,stay,94,140,0,234
7,7,7,double,23,87,5,115
7,7,7,hit,18,76,2,96
7,7,7,stay,41,132,0,173
7,7,8,double,36,103,5,144
7,7,8,hit,11,45,2,58
7,7,8,stay,59,145,0,204
7,7,9,double,28,107,3,138
7,7,9,hit,14,71,3,88
7,7,9,stay,40,181,0,221
7,7,A,double,19,114,6,139
7,7,A,hit,9,73,3,85
7,7,A,stay,14,213,0,227
7,8,10,double,104,464,18,586
7,8,10,hit,51,236,15,302
7,8,10,stay,204,731,0,935
7,8,2,double,44,146,6,196
7,8,2,hit,15,51,2,68
7,8,2,stay,85,167,0,252
7,8,3,double,29,108,4,141
7,8,3,hit,23,65,2,90
7,8,3,stay,74,141,0,215
7,8,4,double,23,125,4,152
7,8,4,hit,20,53,4,77
7,8,4,stay,103,191,0,294
7,8,5,double,32,109,13,154
7,8,5,hit,15,53,3,71
7,8,5,stay,94,154,0,248
7,8,6,double,30,95,5,130
7,8,6,hit,13,62,3,78
7,8,6,stay,108,102,0,210
7,8,7,double,39,106,2,147
7,8,7,hit,16,69,3,88
7,8,7,stay,65,166,0,231
7,8,8,double,23,114,4,141
7,8,8,hit,13,46,4,63
7,8,8,stay,57,183,0,240
7,8,9,double,27,125,6,158
7,8,9,hit,11,62,2,75
7,8,9,stay,42,168,0,210
7,8,A,double,17,140,5,162
7,8,A,hit,6,72,4,82
7,8,A,stay,14,216,0,230
7,9,10,double,91,529,18,638
7,9,10,hit,42,243,11,296
7,9,10,stay,161,731,0,892
7,9,2,double,31,110,5,146
7,9,2,hit,12,52,4,68
7,9,2,stay,81,149,0,230
7,9,3,double,29,135,7,171
7,9,3,hit,16,61,1,78
7,9,3,stay,65,152,0,217
7,9,4,double,39,151,3,193
7,9,4,hit,16,69,1,86
7,9,4,stay,91,152,0,243
7,9,5,double,29,135,6,170
7,9,5,hit,5,53,2,60
7,9,5,stay,82,132,0,214
7,9,6,double,29,157,6,192
7,9,6,hit,6,53,0,59
7,9,6,stay,98,136,0,234
7,9,7,double,40,120,4,164
7,9,7,hit,9,48,1,58
7,9,7,stay,62,161,0,223
7,9,8,double,26,111,5,142
7,9,8,hit,13,84,1,98
7,9,8,stay,52,181,0,233
7,9,9,double,29,121,3,153
7,9,9,hit,11,64,2,77
7,9,9,stay,39,183,0,222
7,9,A,double,24,117,11,152
7,9,A,hit,8,63,5,76
7,9,A,stay,11,205,0,216
7,A,10,double,213,353,57,623
7,A,10,hit,105,186,23,314
7,A,10,stay,326,476,99,901
7,A,2,double,69,92,7,168
7,A,2,hit,39,34,7,80
7,A,2,stay,95,103,34,232
7,A,3,double,60,71,10,141
7,A,3,hit,22,30,2,54
7,A,3,stay,93,97,32,222
7,A,4,double,83,65,14,162
7,A,4,hit,44,37,4,85
7,A,4,stay,128,85,37,250
7,A,5,double,72,60,6,138
7,A,5,hit,33,30,6,69
7,A,5,stay,125,86,31,242
7,A,6,double,107,75,11,193
7,A,6,hit,44,35,5,84
7,A,6,stay,137,78,24,239
7,A,7,double,62,54,13,129
7,A,7,hit,24,28,5,57
7,A,7,stay,147,50,43,240
7,A,8,double,53,69,14,136
7,A,8,hit,31,49,8,88
7,A,8,stay,77,60,80,217
7,A,9,double,58,78,17,153
7,A,9,hit,30,49,1,80
7,A,9,stay,68,123,36,227
7,A,A,double,31,81,21,133
7,A,A,hit,13,54,8,75
7,A,A,stay,46,149,20,215
8,10,10,double,285,2092,83,2460
8,10,10,hit,134,975,35,1144
8,10,10,stay,1141,2039,401,3581
8,10,2,double,80,493,13,586
8,10,2,hit,39,252,3,294
8,10,2,stay,433,377,127,937
8,10,3,double,101,542,15,658
8,10,3,hit,42,230,7,279
8,10,3,stay,428,334,116,878
8,10,4,double,90,524,17,631
8,10,4,hit,41,256,7,304
8,10,4,stay,478,342,128,948
8,10,5,double,78,513,15,606
8,10,5,hit,52,256,6,314
8,10,5,stay,474,342,144,960
8,10,6,double,96,517,9,622
8,10,6,hit,50,253,10,313
8,10,6,stay,496,321,118,935
8,10,7,double,83,541,5,629
8,10,7,hit,41,229,4,274
8,10,7,stay,592,215,125,932
8,10,8,double,92,474,6,572
8,10,8,hit,36,229,4,269
8,10,8,stay,307,214,290,811
8,10,9,double,68,521,18,607
8,10,9,hit,42,261,6,309
8,10,9,stay,292,469,114,875
8,10,A,double,52,532,27,611
8,10,A,hit,31,250,10,291
8,10,A,stay,174,603,128,905
8,2,10,double,172,462,49,683
8,2,10,hit,88,165,26,279
8,2,10,stay,155,722,0,877
8,2,2,double,59,71,6,136
8,2,2,hit,30,45,7,82
8,2,2,stay,69,147,0,216
8,2,3,double,54,81,4,139
8,2,3,hit,27,46,6,79
8,2,3,stay,90,135,0,225
8,2,4,double,65,103,9,177
8,2,4,hit,20,35,3,58
8,2,4,stay,81,175,0,256
8,2,5,double,66,80,8,154
8,2,5,hit,19,43,3,65
8,2,5,stay,97,123,0,220
8,2,6,double,72,93,8,173
8,2,6,hit,37,42,2,81
8,2,6,stay,89,122,0,211
8,2,7,double,59,100,8,167
8,2,7,hit,35,53,2,90
8,2,7,stay,72,181,0,253
8,2,8,double,60,86,9,155
8,2,8,hit,35,38,0,73
8,2,8,stay,54,178,0,232
8,2,9,double,54,104,9,167
8,2,9,hit,28,49,5,82
8,2,9,stay,50,189,0,239
8,2,A,double,31,107,22,160
8,2,A,hit,15,59,8,82
8,2,A,stay,6,222,0,228
8,3,10,double,277,294,44,615
8,3,10,hit,114,144,21,279
8,3,10,stay,203,741,0,944
8,3,2,double,80,67,11,158
8,3,2,hit,36,45,3,84
8,3,2,stay,73,139,0,212
8,3,3,double,72,64,9,145
8,3,3,hit,41,45,6,92
8,3,3,stay,72,153,0,225
8,3,4,double,88,68,6,162
8,3,4,hit,38,27,4,69
8,3,4,stay,87,135,0,222
8,3,5,double,101,66,11,178
8,3,5,hit,32,38,6,76
8,3,5,stay,90,119,0,209
8,3,6,double,90,58,8,156
8,3,6,hit,36,33,4,73
8,3,6,stay,93,142,0,235
8,3,7,double,96,67,6,169
8,3,7,hit,49,36,10,95
8,3,7,stay,58,180,0,238
8,3,8,double,79,66,6,151
8,3,8,hit,41,41,4,86
8,3,8,stay,35,178,0,213
8,3,9,double,64,76,9,149
8,3,9,hit,47,51,6,104
8,3,9,stay,53,172,0,225
8,3,A,double,39,86,20,145
8,3,A,hit,23,30,17,70
8,3,A,stay,10,211,0,221
8,4,10,double,128,422,35,585
8,4,10,hit,56,245,14,315
8,4,10,stay,168,771,0,939
8,4,2,double,55,84,8,147
8,4,2,hit,15,60,2,77
8,4,2,stay,75,160,0,235
8,4,3,double,40,108,6,154
8,4,3,hit,22,66,2,90
8,4,3,stay,66,148,0,214
8,4,4,double,37,105,6,148
8,4,4,hit,20,47,2,69
8,4,4,stay,89,136,0,225
8,4,5,double,46,109,7,162
8,4,5,hit,19,50,3,72
8,4,5,stay,84,144,0,228
8,4,6,double,38,101,5,144
8,4,6,hit,21,46,2,69
8,4,6,stay,88,125,0,213
8,4,7,double,52,89,9,150
8,4,7,hit,23,71,9,103
8,4,7,stay,60,169,0,229
8,4,8,double,38,86,5,129
8,4,8,hit,18,56,2,76
8,4,8,stay,56,200,0,256
8,4,9,double,40,114,6,160
8,4,9,hit,20,56,7,83
8,4,9,stay,54,186,0,240
8,4,A,double,19,134,8,161
8,4,A,hit,12,60,4,76
8,4,A,stay,10,208,0,218
8,5,10,double,100,466,15,581
8,5,10,hit,52,255,13,320
8,5,10,stay,199,741,0,940
8,5,2,double,42,106,1,149
8,5,2,hit,17,59,4,80
8,5,2,stay,74,152,0,226
8,5,3,double,27,110,4,141
8,5,3,hit,20,64,2,86
8,5,3,stay,86,164,0,250
8,5,4,double,36,110,2,148
8,5,4,hit,22,56,3,81
8,5,4,stay,71,162,0,233
8,5,5,double,38,98,3,139
8,5,5,hit,15,46,3,64
8,5,5,stay,83,172,0,255
8,5,6,double,38,101,4,143
8,5,6,hit,24,54,1,79
8,5,6,stay,105,156,0,261
8,5,7,double,44,130,8,182
8,5,7,hit,19,49,4,72
8,5,7,stay,59,184,0,243
8,5,8,double,37,108,7,152
8,5,8,hit,9,55,4,68
8,5,8,stay,55,151,0,206
8,5,9,double,38,121,8,167
8,5,9,hit,20,73,3,96
8,5,9,stay,48,173,0,221
8,5,A,double,21,105,7,133
8,5,A,hit,7,51,3,61
8,5,A,stay,10,210,0,220
8,6,10,double,119,483,29,631
8,6,10,hit,58,245,13,316
8,6,10,stay,181,727,0,908
8,6,2,double,33,111,3,147
8,6,2,hit,17,69,3,89
8,6,2,stay,80,160,0,240
8,6,3,double,34,109,5,148
8,6,3,hit,12,53,4,69
8,6,3,stay,80,136,0,216
8,6,4,double,39,99,4,142
8,6,4,hit,10,62,6,78
8,6,4,stay,92,146,0,238
8,6,5,double,36,124,2,162
8,6,5,hit,12,56,1,69
8,6,5,stay,96,138,0,234
8,6,6,double,31,99,5,135
8,6,6,hit,19,55,2,76
8,6,6,stay,92,119,0,211
8,6,7,double,38,106,3,147
8,6,7,hit,19,53,2,74
8,6,7,stay,52,159,0,211
8,6,8,double,30,100,4,134
8,6,8,hit,18,47,5,70
8,6,8,stay,67,177,0,244
8,6,9,double,31,135,3,169
8,6,9,hit,14,63,1,78
8,6,9,stay,37,181,0,218
8,6,A,double,24,122,12,158
8,6,A,hit,9,54,2,65
8,6,A,stay,13,217,0,230
8,7,10,double,103,458,33,594
8,7,10,hit,60,268,16,344
8,7,10,stay,177,756,0,933
8,7,2,double,31,115,5,151
8,7,2,hit,15,60,0,75
8,7,2,stay,80,151,0,231
8,7,3,double,31,117,4,152
8,7,3,hit,16,75,3,94
8,7,3,stay,73,134,0,207
8,7,4,double,36,98,7,141
8,7,4,hit,15,59,6,80
8,7,4,stay,92,132,0,224
8,7,5,double,21,125,3,149
8,7,5,hit,10,74,0,84
8,7,5,stay,85,119,0,204
8,7,6,double,35,113,2,150
8,7,6,hit,20,52,0,72
8,7,6,stay,88,136,0,224
8,7,7,double,37,123,7,167
8,7,7,hit,19,54,1,74
8,7,7,stay,59,169,0,228
8,7,8,double,17,108,8,133
8,7,8,hit,15,42,6,63
8,7,8,stay,37,154,0,191
8,7,9,double,31,121,5,157
8,7,9,hit,13,55,8,76
8,7,9,stay,34,181,0,215
8,7,A,double,14,132,13,159
8,7,A,hit,8,57,7,72
8,7,A,stay,14,230,0,244
8,8,10,double,98,482,37,617
8,8,10,hit,44,211,8,263
8,8,10,stay,176,686,0,862
8,8,2,double,18,110,4,132
8,8,2,hit,14,60,2,76
8,8,2,stay,65,148,0,213
8,8,3,double,24,106,3,133
8,8,3,hit,15,57,3,75
8,8,3,stay,74,132,0,206
8,8,4,double,30,94,8,132
8,8,4,hit,11,62,1,74
8,8,4,stay,86,134,0,220
8,8,5,double,30,118,5,153
8,8,5,hit,20,46,4,70
8,8,5,stay,87,136,0,223
8,8,6,double,27,115,3,145
8,8,6,hit,13,53,3,69
8,8,6,stay,86,133,0,219
8,8,7,double,30,111,3,144
8,8,7,hit,11,63,5,79
8,8,7,stay,64,135,0,199
8,8,8,double,16,103,3,122
8,8,8,hit,20,56,6,82
8,8,8,stay,48,141,0,189
8,8,9,double,20,127,5,152
8,8,9,hit,7,62,3,72
8,8,9,stay,46,161,0,207
8,8,A,double,11,131,8,150
8,8,A,hit,11,64,0,75
8,8,A,stay,6,221,0,227
8,9,10,double,82,508,17,607
8,9,10,hit,52,284,15,351
8,9,10,stay,170,658,117,945
8,9,2,double,15,111,4,130
8,9,2,hit,12,76,0,88
8,9,2,stay,75,121,31,227
8,9,3,double,20,109,1,130
8,9,3,hit,9,64,1,74
8,9,3,stay,93,113,33,239
8,9,4,double,22,130,3,155
8,9,4,hit,9,53,1,63
8,9,4,stay,79,115,40,234
8,9,5,double,23,111,4,138
8,9,5,hit,11,48,2,61
8,9,5,stay,79,105,32,216
8,9,6,double,23,125,3,151
8,9,6,hit,10,54,2,66
8,9,6,stay,102,98,48,248
8,9,7,double,25,105,3,133
8,9,7,hit,23,70,1,94
8,9,7,stay,51,85,76,212
8,9,8,double,19,121,5,145
8,9,8,hit,9,50,1,60
8,9,8,stay,45,135,26,206
8,9,9,double,28,117,1,146
8,9,9,hit,11,56,3,70
8,9,9,stay,43,135,33,211
8,9,A,double,18,133,6,157
8,9,A,hit,8,75,1,84
8,9,A,stay,13,195,31,239
8,A,10,double,205,372,42,619
8,A,10,hit,107,159,40,306
8,A,10,stay,360,410,106,876
8,A,2,double,68,81,12,161
8,A,2,hit,44,25,1,70
8,A,2,stay,140,59,44,243
8,A,3,double,60,59,8,127
8,A,3,hit,43,32,9,84
8,A,3,stay,150,63,31,244
8,A,4,double,79,67,13,159
8,A,4,hit,34,30,4,68
8,A,4,stay,123,64,33,220
8,A,5,double,78,66,11,155
8,A,5,hit,35,36,5,76
8,A,5,stay,152,56,31,239
8,A,6,double,82,80,9,171
8,A,6,hit,42,35,4,81
8,A,6,stay,172,41,21,234
8,A,7,double,58,62,9,129
8,A,7,hit,29,36,4,69
8,A,7,stay,162,36,10,208
8,A,8,double,62,67,9,138
8,A,8,hit,29,39,5,73
8,A,8,stay,150,32,33,215
8,A,9,double,57,81,17,155
8,A,9,hit,36,42,10,88
8,A,9,stay,107,53,93,253
8,A,A,double,33,95,17,145
8,A,A,hit,12,36,11,59
8,A,A,stay,76,103,35,214
9,10,10,double,224,2068,64,2356
9,10,10,hit,135,992,25,1152
9,10,10,stay,1658,1686,379,3723
9,10,2,double,74,510,10,594
9,10,2,hit,39,277,4,320
9,10,2,stay,575,222,130,927
9,10,3,double,63,526,8,597
9,10,3,hit,37,274,6,317
9,10,3,stay,572,219,140,931
9,10,4,double,81,585,8,674
9,10,4,hit,30,277,6,313
9,10,4,stay,568,262,131,961
9,10,5,double,76,503,8,587
9,10,5,hit,39,254,6,299
9,10,5,stay,588,223,118,929
9,10,6,double,71,590,11,672
9,10,6,hit,29,283,7,319
9,10,6,stay,646,193,91,930
9,10,7,double,69,531,6,606
9,10,7,hit,48,256,2,306
9,10,7,stay,688,154,72,914
9,10,8,double,64,515,4,583
9,10,8,hit,33,276,5,314
9,10,8,stay,686,126,122,934
9,10,9,double,70,540,6,616
9,10,9,hit,35,272,5,312
9,10,9,stay,377,144,339,860
9,10,A,double,36,548,23,607
9,10,A,hit,34,281,10,325
9,10,A,stay,307,504,123,934
9,2,10,double,269,281,60,610
9,2,10,hit,128,155,25,308
9,2,10,stay,225,763,0,988
9,2,2,double,74,69,8,151
9,2,2,hit,35,33,3,71
9,2,2,stay,65,148,0,213
9,2,3,double,80,57,7,144
9,2,3,hit,39,39,5,83
9,2,3,stay,67,162,0,229
9,2,4,double,70,76,10,156
9,2,4,hit,38,29,4,71
9,2,4,stay,81,142,0,223
9,2,5,double,85,84,5,174
9,2,5,hit,30,38,4,72
9,2,5,stay,87,151,0,238
9,2,6,double,76,76,6,158
9,2,6,hit,41,26,2,69
9,2,6,stay,87,149,0,236
9,2,7,double,70,73,17,160
9,2,7,hit,46,34,1,81
9,2,7,stay,57,161,0,218
9,2,8,double,67,62,7,136
9,2,8,hit,44,36,5,85
9,2,8,stay,55,174,0,229
9,2,9,double,67,65,10,142
9,2,9,hit,30,28,1,59
9,2,9,stay,38,190,0,228
9,2,A,double,37,66,21,124
9,2,A,hit,18,53,15,86
9,2,A,stay,5,220,0,225
9,3,10,double,104,484,37,625
9,3,10,hit,62,226,13,301
9,3,10,stay,209,757,0,966
9,3,2,double,43,103,6,152
9,3,2,hit,16,54,3,73
9,3,2,stay,80,153,0,233
9,3,3,double,35,96,7,138
9,3,3,hit,24,49,0,73
9,3,3,stay,73,154,0,227
9,3,4,double,35,106,8,149
9,3,4,hit,20,60,4,84
9,3,4,stay,88,141,0,229
9,3,5,double,45,114,3,162
9,3,5,hit,19,52,1,72
9,3,5,stay,92,124,0,216
9,3,6,double,47,99,4,150
9,3,6,hit,19,52,3,74
9,3,6,stay,85,119,0,204
9,3,7,double,41,99,6,146
9,3,7,hit,20,53,6,79
9,3,7,stay,63,177,0,240
9,3,8,double,41,97,9,147
9,3,8,hit,22,49,3,74
9,3,8,stay,48,156,0,204
9,3,9,double,25,109,3,137
9,3,9,hit,14,51,2,67
9,3,9,stay,53,166,0,219
9,3,A,double,19,135,10,164
9,3,A,hit,11,53,2,66
9,3,A,stay,14,214,0,228
9,4,10,double,108,485,31,624
9,4,10,hit,66,241,12,319
9,4,10,stay,190,662,0,852
9,4,2,double,38,118,4,160
9,4,2,hit,18,51,2,71
9,4,2,stay,65,143,0,208
9,4,3,double,47,112,7,166
9,4,3,hit,18,47,4,69
9,4,3,stay,75,142,0,217
9,4,4,double,24,105,8,137
9,4,4,hit,12,57,1,70
9,4,4,stay,65,134,0,199
9,4,5,double,31,104,8,143
9,4,5,hit,22,56,7,85
9,4,5,stay,110,129,0,239
9,4,6,double,45,99,8,152
9,4,6,hit,24,39,2,65
9,4,6,stay,87,132,0,219
9,4,7,double,39,121,9,169
9,4,7,hit,17,55,2,74
9,4,7,stay,58,198,0,256
9,4,8,double,37,104,1,142
9,4,8,hit,12,62,4,78
9,4,8,stay,57,168,0,225
9,4,9,double,19,124,6,149
9,4,9,hit,14,53,5,72
9,4,9,stay,56,171,0,227
9,4,A,double,17,121,9,147
9,4,A,hit,6,69,5,80
9,4,A,stay,8,233,0,241
9,5,10,double,99,483,27,609
9,5,10,hit,53,242,21,316
9,5,10,stay,168,766,0,934
9,5,2,double,37,130,4,171
9,5,2,hit,26,54,1,81
9,5,2,stay,68,147,0,215
9,5,3,double,39,109,6,154
9,5,3,hit,21,54,5,80
9,5,3,stay,82,154,0,236
9,5,4,double,25,122,4,151
9,5,4,hit,15,61,3,79
9,5,4,stay,88,134,0,222
9,5,5,double,34,112,9,155
9,5,5,hit,15,51,4,70
9,5,5,stay,96,123,0,219
9,5,6,double,32,92,9,133
9,5,6,hit,22,56,4,82
9,5,6,stay,99,137,0,236
9,5,7,double,35,109,6,150
9,5,7,hit,15,59,0,74
9,5,7,stay,61,149,0,210
9,5,8,double,18,106,6,130
9,5,8,hit,20,50,2,72
9,5,8,stay,62,182,0,244
9,5,9,double,32,119,10,161
9,5,9,hit,13,49,4,66
9,5,9,stay,49,166,0,215
9,5,A,double,13,133,11,157
9,5,A,hit,14,60,5,79
9,5,A,stay,18,245,0,263
9,6,10,double,95,501,30,626
9,6,10,hit,51,242,20,313
9,6,10,stay,186,723,0,909
9,6,2,double,38,114,7,159
9,6,2,hit,17,59,1,77
9,6,2,stay,81,155,0,236
9,6,3,double,24,108,5,137
9,6,3,hit,15,56,5,76
9,6,3,stay,80,149,0,229
9,6,4,double,33,118,5,156
9,6,4,hit,20,52,1,73
9,6,4,stay,83,158,0,241
9,6,5,double,34,110,3,147
9,6,5,hit,20,64,2,86
9,6,5,stay,97,147,0,244
9,6,6,double,25,113,3,141
9,6,6,hit,15,60,2,77
9,6,6,stay,86,124,0,210
9,6,7,double,30,103,11,144
9,6,7,hit,18,52,4,74
9,6,7,stay,61,186,0,247
9,6,8,double,30,117,4,151
9,6,8,hit,11,63,0,74
9,6,8,stay,52,158,0,210
9,6,9,double,26,135,4,165
9,6,9,hit,14,59,2,75
9,6,9,stay,50,161,0,211
9,6,A,double,15,128,11,154
9,6,A,hit,5,65,4,74
9,6,A,stay,17,212,0,229
9,7,10,double,88,512,26,626
9,7,10,hit,47,254,11,312
9,7,10,stay,209,705,0,914
9,7,2,double,28,115,7,150
9,7,2,hit,9,51,4,64
9,7,2,stay,58,149,0,207
9,7,3,double,17,106,7,130
9,7,3,hit,18,56,0,74
9,7,3,stay,86,138,0,224
9,7,4,double,23,130,6,159
9,7,4,hit,16,65,0,81
9,7,4,stay,75,151,0,226
9,7,5,double,25,101,1,127
9,7,5,hit,10,62,3,75
9,7,5,stay,89,134,0,223
9,7,6,double,25,125,5,155
9,7,6,hit,8,56,3,67
9,7,6,stay,96,131,0,227
9,7,7,double,27,125,2,154
9,7,7,hit,12,62,1,75
9,7,7,stay,49,149,0,198
9,7,8,double,27,119,6,152
9,7,8,hit,15,55,5,75
9,7,8,stay,50,179,0,229
9,7,9,double,19,129,9,157
9,7,9,hit,11,53,2,66
9,7,9,stay,37,171,0,208
9,7,A,double,14,113,8,135
9,7,A,hit,12,50,5,67
9,7,A,stay,11,226,0,237
9,8,10,double,103,531,19,653
9,8,10,hit,45,267,12,324
9,8,10,stay,192,643,111,946
9,8,2,double,21,111,4,136
9,8,2,hit,13,55,0,68
9,8,2,stay,71,98,27,196
9,8,3,double,30,130,1,161
9,8,3,hit,14,58,1,73
9,8,3,stay,66,119,26,211
9,8,4,double,19,133,3,155
9,8,4,hit,18,84,3,105
9,8,4,stay,87,121,37,245
9,8,5,double,24,118,7,149
9,8,5,hit,18,60,4,82
9,8,5,stay,90,111,28,229
9,8,6,double,22,111,2,135
9,8,6,hit,12,70,1,83
9,8,6,stay,97,99,41,237
9,8,7,double,29,114,2,145
9,8,7,hit,18,75,3,96
9,8,7,stay,83,107,81,271
9,8,8,double,26,115,4,145
9,8,8,hit,16,56,4,76
9,8,8,stay,51,159,27,237
9,8,9,double,16,128,3,147
9,8,9,hit,12,55,1,68
9,8,9,stay,47,135,24,206
9,8,A,double,21,131,9,161
9,8,A,hit,4,59,3,66
9,8,A,stay,14,213,25,252
9,9,10,double,76,504,16,596
9,9,10,hit,38,264,11,313
9,9,10,stay,289,520,106,915
9,9,2,double,15,122,5,142
9,9,2,hit,5,56,1,62
9,9,2,stay,114,95,39,248
9,9,3,double,21,141,6,168
9,9,3,hit,9,64,1,74
9,9,3,stay,116,104,33,253
9,9,4,double,23,112,1,136
9,9,4,hit,9,63,0,72
9,9,4,stay,99,87,29,215
9,9,5,double,27,118,3,148
9,9,5,hit,9,68,2,79
9,9,5,stay,113,78,24,215
9,9,6,double,22,131,1,154
9,9,6,hit,8,74,0,82
9,9,6,stay,152,72,20,244
9,9,7,double,24,104,1,129
9,9,7,hit,10,72,1,83
9,9,7,stay,131,41,28,200
9,9,8,double,20,125,1,146
9,9,8,hit,13,61,0,74
9,9,8,stay,58,65,73,196
9,9,9,double,11,102,2,115
9,9,9,hit,11,60,8,79
9,9,9,stay,62,91,23,176
9,9,A,double,10,114,7,131
9,9,A,hit,5,60,4,69
9,9,A,stay,44,144,33,221
9,A,10,double,226,340,62,628
9,A,10,hit,108,170,27,305
9,A,10,stay,511,97,325,933
9,A,2,double,83,70,9,162
9,A,2,hit,30,40,7,77
9,A,2,stay,172,27,25,224
9,A,3,double,82,62,10,154
9,A,3,hit,32,37,6,75
9,A,3,stay,166,26,32,224
9,A,4,double,82,72,14,168
9,A,4,hit,36,31,8,75
9,A,4,stay,204,23,28,255
9,A,5,double,77,65,11,153
9,A,5,hit,49,30,6,85
9,A,5,stay,194,23,21,238
9,A,6,double,80,77,8,165
9,A,6,hit,46,28,5,79
9,A,6,stay,187,20,24,231
9,A,7,double,80,69,11,160
9,A,7,hit,44,33,6,83
9,A,7,stay,200,20,21,241
9,A,8,double,73,68,15,156
9,A,8,hit,46,26,7,79
9,A,8,stay,198,16,14,228
9,A,9,double,72,70,3,145
9,A,9,hit,23,42,4,69
9,A,9,stay,196,9,18,223
9,A,A,double,31,95,20,146
9,A,A,hit,12,34,5,51
9,A,A,stay,92,76,26,194
A,10,10,blackjack,6481,0,811,7292
A,10,2,blackjack,1583,0,218,1801
A,10,3,blackjack,1671,0,222,1893
A,10,4,blackjack,1685,0,210,1895
A,10,5,blackjack,1669,0,212,1881
A,10,6,blackjack,1665,0,176,1841
A,10,7,blackjack,1763,0,138,1901
A,10,8,blackjack,1685,0,130,1815
A,10,9,blackjack,1748,0,107,1855
A,10,A,blackjack,1063,0,641,1704
A,2,10,double,199,380,39,618
A,2,10,hit,93,188,18,299
A,2,10,stay,192,692,0,884
A,2,2,double,62,78,5,145
A,2,2,hit,38,34,6,78
A,2,2,stay,66,131,0,197
A,2,3,double,66,80,13,159
A,2,3,hit,34,35,0,69
A,2,3,stay,79,144,0,223
A,2,4,double,66,73,8,147
A,2,4,hit,32,45,3,80
A,2,4,stay,71,134,0,205
A,2,5,double,78,77,8,163
A,2,5,hit,44,42,4,90
A,2,5,stay,93,143,0,236
A,2,6,double,81,67,4,152
A,2,6,hit,46,38,2,86
A,2,6,stay,96,139,0,235
A,2,7,double,62,87,5,154
A,2,7,hit,20,34,6,60
A,2,7,stay,64,175,0,239
A,2,8,double,57,73,10,140
A,2,8,hit,29,53,7,89
A,2,8,stay,61,189,0,250
A,2,9,double,61,95,10,166
A,2,9,hit,24,36,3,63
A,2,9,stay,47,194,0,241
A,2,A,double,39,116,10,165
A,2,A,hit,4,48,7,59
A,2,A,stay,13,191,0,204
A,3,10,double,203,374,38,615
A,3,10,hit,104,177,16,297
A,3,10,stay,195,672,0,867
A,3,2,double,68,98,10,176
A,3,2,hit,38,41,2,81
A,3,2,stay,69,172,0,241
A,3,3,double,76,81,9,166
A,3,3,hit,36,37,2,75
A,3,3,stay,80,150,0,230
A,3,4,double,71,77,8,156
A,3,4,hit,41,30,4,75
A,3,4,stay,89,126,0,215
A,3,5,double,87,77,8,172
A,3,5,hit,41,28,7,76
A,3,5,stay,89,129,0,218
A,3,6,double,62,55,6,123
A,3,6,hit,39,28,9,76
A,3,6,stay,79,143,0,222
A,3,7,double,61,100,13,174
A,3,7,hit,34,40,8,82
A,3,7,stay,51,190,0,241
A,3,8,double,48,74,12,134
A,3,8,hit,32,33,5,70
A,3,8,stay,69,171,0,240
A,3,9,double,49,90,7,146
A,3,9,hit,32,38,2,72
A,3,9,stay,55,190,0,245
A,3,A,double,23,103,18,144
A,3,A,hit,11,66,13,90
A,3,A,stay,13,192,0,205
A,4,10,double,211,366,50,627
A,4,10,hit,110,177,18,305
A,4,10,stay,188,732,0,920
A,4,2,double,57,82,15,154
A,4,2,hit,24,51,2,77
A,4,2,stay,83,170,0,253
A,4,3,double,61,72,4,137
A,4,3,hit,27,38,5,70
A,4,3,stay,81,161,0,242
A,4,4,double,64,58,14,136
A,4,4,hit,40,29,1,70
A,4,4,stay,88,124,0,212
A,4,5,double,73,71,6,150
A,4,5,hit,36,44,4,84
A,4,5,stay,109,131,0,240
A,4,6,double,76,56,3,135
A,4,6,hit,39,31,5,75
A,4,6,stay,91,144,0,235
A,4,7,double,80,70,10,160
A,4,7,hit,31,30,5,66
A,4,7,stay,68,185,0,253
A,4,8,double,59,81,9,149
A,4,8,hit,24,42,10,76
A,4,8,stay,51,186,0,237
A,4,9,double,77,69,9,155
A,4,9,hit,34,52,2,88
A,4,9,stay,58,160,0,218
A,4,A,double,25,99,14,138
A,4,A,hit,17,45,3,65
A,4,A,stay,6,208,0,214
A,5,10,double,200,348,38,586
A,5,10,hit,94,199,20,313
A,5,10,stay,191,775,0,966
A,5,2,double,57,68,5,130
A,5,2,hit,34,52,3,89
A,5,2,stay,80,145,0,225
A,5,3,double,79,77,14,170
A,5,3,hit,35,35,4,74
A,5,3,stay,87,146,0,233
A,5,4,double,79,75,3,157
A,5,4,hit,42,45,5,92
A,5,4,stay,83,182,0,265
A,5,5,double,66,79,10,155
A,5,5,hit,25,32,3,60
A,5,5,stay,87,124,0,211
A,5,6,double,72,85,12,169
A,5,6,hit,26,34,4,64
A,5,6,stay,113,142,0,255
A,5,7,double,72,72,3,147
A,5,7,hit,39,46,4,89
A,5,7,stay,57,168,0,225
A,5,8,double,74,66,7,147
A,5,8,hit,28,43,2,73
A,5,8,stay,54,184,0,238
A,5,9,double,68,103,12,183
A,5,9,hit,32,45,5,82
A,5,9,stay,63,158,0,221
A,5,A,double,28,98,11,137
A,5,A,hit,10,49,7,66
A,5,A,stay,18,195,0,213
A,6,10,double,192,347,53,592
A,6,10,hit,122,175,17,314
A,6,10,stay,185,636,92,913
A,6,2,double,51,63,12,126
A,6,2,hit,37,30,5,72
A,6,2,stay,78,121,35,234
A,6,3,double,55,56,14,125
A,6,3,hit,31,31,2,64
A,6,3,stay,81,107,39,227
A,6,4,double,79,62,10,151
A,6,4,hit,32,34,2,68
A,6,4,stay,86,87,27,200
A,6,5,double,67,64,8,139
A,6,5,hit,39,41,2,82
A,6,5,stay,76,119,32,227
A,6,6,double,64,71,8,143
A,6,6,hit,33,29,1,63
A,6,6,stay,89,73,35,197
A,6,7,double,68,87,13,168
A,6,7,hit,41,38,6,85
A,6,7,stay,50,85,88,223
A,6,8,double,69,71,15,155
A,6,8,hit,31,35,4,70
A,6,8,stay,67,135,34,236
A,6,9,double,59,92,9,160
A,6,9,hit,38,36,2,76
A,6,9,stay,52,138,28,218
A,6,A,double,26,98,16,140
A,6,A,hit,15,51,10,76
A,6,A,stay,7,200,36,243
A,7,10,double,184,376,60,620
A,7,10,hit,112,166,24,302
A,7,10,stay,327,552,92,971
A,7,2,double,65,67,14,146
A,7,2,hit,40,49,1,90
A,7,2,stay,100,101,24,225
A,7,3,double,84,79,11,174
A,7,3,hit,27,32,5,64
A,7,3,stay,118,94,25,237
A,7,4,double,77,71,11,159
A,7,4,hit,37,38,6,81
A,7,4,stay,115,76,33,224
A,7,5,double,62,61,12,135
A,7,5,hit,46,40,12,98
A,7,5,stay,95,92,33,220
A,7,6,double,87,69,10,166
A,7,6,hit,40,31,10,81
A,7,6,stay,135,85,27,247
A,7,7,double,75,56,12,143
A,7,7,hit,27,28,3,58
A,7,7,stay,127,48,28,203
A,7,8,double,78,66,15,159
A,7,8,hit,36,36,5,77
A,7,8,stay,93,55,74,222
A,7,9,double,68,73,12,153
A,7,9,hit,21,43,10,74
A,7,9,stay,79,119,16,214
A,7,A,double,28,97,19,144
A,7,A,hit,18,49,6,73
A,7,A,stay,39,133,36,208
A,8,10,double,225,351,46,622
A,8,10,hit,116,155,27,298
A,8,10,stay,424,402,94,920
A,8,2,double,74,72,15,161
A,8,2,hit,35,38,8,81
A,8,2,stay,126,45,33,204
A,8,3,double,88,64,13,165
A,8,3,hit,27,25,5,57
A,8,3,stay,137,62,37,236
A,8,4,double,81,72,8,161
A,8,4,hit,30,35,3,68
A,8,4,stay,141,69,33,243
A,8,5,double,87,70,9,166
A,8,5,hit,53,31,6,90
A,8,5,stay,139,57,29,225
A,8,6,double,82,67,6,155
A,8,6,hit,44,18,1,63
A,8,6,stay,152,43,30,225
A,8,7,double,78,86,10,174
A,8,7,hit,37,25,3,65
A,8,7,stay,201,30,18,249
A,8,8,double,60,78,12,150
A,8,8,hit,31,43,2,76
A,8,8,stay,154,30,35,219
A,8,9,double,68,82,18,168
A,8,9,hit,38,34,6,78
A,8,9,stay,119,47,100,266
A,8,A,double,34,94,14,142
A,8,A,hit,16,39,12,67
A,8,A,stay,77,119,34,230
A,9,10,double,193,353,66,612
A,9,10,hit,112,178,41,331
A,9,10,stay,480,97,305,882
A,9,2,double,76,69,9,154
A,9,2,hit,36,35,4,75
A,9,2,stay,173,31,39,243
A,9,3,double,69,72,5,146
A,9,3,hit,45,40,2,87
A,9,3,stay,161,36,37,234
A,9,4,double,76,82,11,169
A,9,4,hit,45,30,6,81
A,9,4,stay,180,30,27,237
A,9,5,double,86,65,20,171
A,9,5,hit,53,36,4,93
A,9,5,stay,191,27,22,240
A,9,6,double,64,69,6,139
A,9,6,hit,46,36,2,84
A,9,6,stay,190,26,23,239
A,9,7,double,79,58,7,144
A,9,7,hit,39,31,3,73
A,9,7,stay,181,15,18,214
A,9,8,double,59,85,14,158
A,9,8,hit,32,24,3,59
A,9,8,stay,190,16,17,223
A,9,9,double,60,66,11,137
A,9,9,hit,33,26,6,65
A,9,9,stay,167,9,31,207
A,9,A,double,27,99,16,142
A,9,A,hit,19,62,5,86
A,9,A,stay,111,79,27,217
A,A,10,double,226,337,48,611
A,A,10,hit,95,141,26,262
A,A,10,stay,179,704,0,883
A,A,2,double,64,50,8,122
A,A,2,hit,32,44,3,79
A,A,2,stay,74,156,0,230
A,A,3,double,75,57,10,142
A,A,3,hit,35,37,6,78
A,A,3,stay,70,134,0,204
A,A,4,double,87,65,11,163
A,A,4,hit,41,35,5,81
A,A,4,stay,75,139,0,214
A,A,5,double,83,59,9,151
A,A,5,hit,28,27,4,59
A,A,5,stay,88,132,0,220
A,A,6,double,78,66,8,152
A,A,6,hit,27,34,5,66
A,A,6,stay,94,109,0,203
A,A,7,double,84,61,10,155
A,A,7,hit,28,41,8,77
A,A,7,stay,53,152,0,205
A,A,8,double,80,58,7,145
A,A,8,hit,33,40,4,77
A,A,8,stay,39,184,0,223
A,A,9,double,66,79,7,152
A,A,9,hit,34,39,4,77
A,A,9,stay,52,153,0,205
A,A,A,double,15,86,9,110
A,A,A,hit,17,39,7,63
A,A,A,stay,9,160,0,169
